KM267719_Lampetra_appendix	Animalia;Chordata;Hyperoartia;Petromyzontiformes;Petromyzontidae;Lampetra;appendix;
KM267716_Ichthyomyzon_fossor	Animalia;Chordata;Hyperoartia;Petromyzontiformes;Petromyzontidae;Ichthyomyzon;fossor;
KM267717_Ichthyomyzon_unicuspis	Animalia;Chordata;Hyperoartia;Petromyzontiformes;Petromyzontidae;Ichthyomyzon;unicuspis;
U11880_Petromyzon_marinus	Animalia;Chordata;Hyperoartia;Petromyzontiformes;Petromyzontidae;Petromyzon;marinus;
AF125594_Polyodon_spathula	Animalia;Chordata;Actinopterygii;Acipenseriformes;Polyodontidae;Polyodon;spathula;
AF125594_Polyodon_spathula_modified	Animalia;Chordata;Actinopterygii;Acipenseriformes;Polyodontidae;Polyodon;spathula;
AF125595_Acipenser_fulvescens	Animalia;Chordata;Actinopterygii;Acipenseriformes;Acipenseridae;Acipenser;fulvescens;
KU985081_Acipenser_fulvescens	Animalia;Chordata;Actinopterygii;Acipenseriformes;Acipenseridae;Acipenser;fulvescens;
JF912031_Lepisosteus_oculatus	Animalia;Chordata;Actinopterygii;Lepisosteiformes;Lepisosteidae;Lepisosteus;oculatus;
AB042861_Lepisosteus_oculatus	Animalia;Chordata;Actinopterygii;Lepisosteiformes;Lepisosteidae;Lepisosteus;oculatus;
DQ536423_Lepisosteus_osseus	Animalia;Chordata;Actinopterygii;Lepisosteiformes;Lepisosteidae;Lepisosteus;osseus;
JF912032_Lepisosteus_osseus	Animalia;Chordata;Actinopterygii;Lepisosteiformes;Lepisosteidae;Lepisosteus;osseus;
JF912030_Lepisosteus_osseus	Animalia;Chordata;Actinopterygii;Lepisosteiformes;Lepisosteidae;Lepisosteus;osseus;
JF912036_Lepisosteus_osseus	Animalia;Chordata;Actinopterygii;Lepisosteiformes;Lepisosteidae;Lepisosteus;osseus;
LNG00001_Lepisosteus_osseus	Animalia;Chordata;Actinopterygii;Lepisosteiformes;Lepisosteidae;Lepisosteus;osseus;
AB042952_Amia_calva	Animalia;Chordata;Actinopterygii;Amiiformes;Amiidae;Amia;calva;
AP009499_Hiodon_tergisus	Animalia;Chordata;Actinopterygii;Hiodontiformes;Hiodontidae;Hiodon;tergisus;
KJ564181_Anguilla_rostrata	Animalia;Chordata;Actinopterygii;Anguilliformes;Anguillidae;Anguilla;rostrata;
AF266497_Anguilla_rostrata	Animalia;Chordata;Actinopterygii;Anguilliformes;Anguillidae;Anguilla;rostrata;
MG570421_Alosa_pseudoharengus   	Animalia;Chordata;Actinopterygii;Clupeiformes;Clupeidae;Alosa;pseudoharengus;
NC037017_Alosa_aestivalis	Animalia;Chordata;Actinopterygii;Clupeiformes;Clupeidae;Alosa;aestivalis;
DQ912046_Alosa_chrysochloris	Animalia;Chordata;Actinopterygii;Clupeiformes;Clupeidae;Alosa;chrysochloris;
DQ912045_Alosa_sapidissima	Animalia;Chordata;Actinopterygii;Clupeiformes;Clupeidae;Alosa;sapidissima;
DQ536426_Dorosoma_cepedianum	Animalia;Chordata;Actinopterygii;Clupeiformes;Clupeidae;Dorosoma;cepedianum;
AP011280_Clinostomus_elongatus	Animalia;Chordata;Actinopterygii;Cypriniformes;Cyprinidae;Clinostomus;elongatus;
AP011274_Couesius_plumbeus	Animalia;Chordata;Actinopterygii;Cypriniformes;Cyprinidae;Couesius;plumbeus;
MF443769_Carassius_auratus	Animalia;Chordata;Actinopterygii;Cypriniformes;Cyprinidae;Carassius;auratus;
DQ536422_Cyprinella_spiloptera	Animalia;Chordata;Actinopterygii;Cypriniformes;Cyprinidae;Cyprinella;spiloptera;
KU681006_Cyprinus_carpio	Animalia;Chordata;Actinopterygii;Cypriniformes;Cyprinidae;Cyprinus;carpio;
KU159761_Cyprinus_carpio	Animalia;Chordata;Actinopterygii;Cypriniformes;Cyprinidae;Cyprinus;carpio;
AP009047_Cyprinus_carpio	Animalia;Chordata;Actinopterygii;Cypriniformes;Cyprinidae;Cyprinus;carpio;
MG570447_Luxilus_cornutus	Animalia;Chordata;Actinopterygii;Cypriniformes;Cyprinidae;Luxilus;cornutus;
AP012079_Luxilus_chrysocephalus	Animalia;Chordata;Actinopterygii;Cypriniformes;Cyprinidae;Luxilus;chrysocephalus;
AP012094_Lythrurus_umbratilis	Animalia;Chordata;Actinopterygii;Cypriniformes;Cyprinidae;Lythrurus;umbratilis;
AY216542_Lythrurus_umbratilis	Animalia;Chordata;Actinopterygii;Cypriniformes;Cyprinidae;Lythrurus;umbratilis;
AF081849_Macrhybopsis_aestivalis	Animalia;Chordata;Actinopterygii;Cypriniformes;Cyprinidae;Macrhybopsis;aestivalis;
KX139438_Macrhybopsis_storeriana	Animalia;Chordata;Actinopterygii;Cypriniformes;Cyprinidae;Macrhybopsis;storeriana;
AF081852_Macrhybopsis_storeriana	Animalia;Chordata;Actinopterygii;Cypriniformes;Cyprinidae;Macrhybopsis;storeriana;
AP012081_Margariscus_margarita	Animalia;Chordata;Actinopterygii;Cypriniformes;Cyprinidae;Margariscus;margarita;
HHC00001_Nocomis_biguttatus	Animalia;Chordata;Actinopterygii;Cypriniformes;Cyprinidae;Nocomis;biguttatus;
MH324421_Nocomis_micropogon	Animalia;Chordata;Actinopterygii;Cypriniformes;Cyprinidae;Nocomis;micropogon;
AF023195_Notropis_atherinoides	Animalia;Chordata;Actinopterygii;Cypriniformes;Cyprinidae;Notropis;atherinoides;
AY216534_Notropis_buccatus	Animalia;Chordata;Actinopterygii;Cypriniformes;Cyprinidae;Notropis;buccatus;
AF148327_Notropis_dorsalis	Animalia;Chordata;Actinopterygii;Cypriniformes;Cyprinidae;Notropis;dorsalis;
KM282434_Notropis_heterodon	Animalia;Chordata;Actinopterygii;Cypriniformes;Cyprinidae;Notropis;heterodon;
MG570414_Notropis_heterolepis	Animalia;Chordata;Actinopterygii;Cypriniformes;Cyprinidae;Notropis;heterolepis;
STS00001_Notropis_hudsonius	Animalia;Chordata;Actinopterygii;Cypriniformes;Cyprinidae;Notropis;hudsonius;
DQ536429_Notropis_stramineus	Animalia;Chordata;Actinopterygii;Cypriniformes;Cyprinidae;Notropis;stramineus;
SAS00001_Notropis_stramineus	Animalia;Chordata;Actinopterygii;Cypriniformes;Cyprinidae;Notropis;stramineus;
AY216553_Notropis_volucellus	Animalia;Chordata;Actinopterygii;Cypriniformes;Cyprinidae;Notropis;volucellus;
MIS00001_Notropis_volucellus	Animalia;Chordata;Actinopterygii;Cypriniformes;Cyprinidae;Notropis;volucellus;
GOS00001_Notemigonus_crysoleucas	Animalia;Chordata;Actinopterygii;Cypriniformes;Cyprinidae;Notemigonus;crysoleucas;
AB127393_Notemigonus_crysoleucas	Animalia;Chordata;Actinopterygii;Cypriniformes;Cyprinidae;Notemigonus;crysoleucas;
AY216543_Notemigonus_crysoleucas	Animalia;Chordata;Actinopterygii;Cypriniformes;Cyprinidae;Notemigonus;crysoleucas;
AY216554_Opsopoeodus_emiliae	Animalia;Chordata;Actinopterygii;Cypriniformes;Cyprinidae;Opsopoeodus;emiliae;
AP012085_Opsopoeodus_emiliae	Animalia;Chordata;Actinopterygii;Cypriniformes;Cyprinidae;Opsopoeodus;emiliae;
DQ536431_Phenacobius_mirabilis	Animalia;Chordata;Actinopterygii;Cypriniformes;Cyprinidae;Phenacobius;mirabilis;
AF038492_Phenacobius_mirabilis	Animalia;Chordata;Actinopterygii;Cypriniformes;Cyprinidae;Phenacobius;mirabilis;
AP009151_Phoxinus_eos	Animalia;Chordata;Actinopterygii;Cypriniformes;Cyprinidae;Phoxinus;eos;
AP011276_Phoxinus_erythrogaster	Animalia;Chordata;Actinopterygii;Cypriniformes;Cyprinidae;Phoxinus;erythrogaster;
AF038493_Phoxinus_neogaeus	Animalia;Chordata;Actinopterygii;Cypriniformes;Cyprinidae;Phoxinus;neogaeus;
KT278765_Pimephales_promelas	Animalia;Chordata;Actinopterygii;Cypriniformes;Cyprinidae;Pimephales;promelas;
AF126357_Pimephales_promelas	Animalia;Chordata;Actinopterygii;Cypriniformes;Cyprinidae;Pimephales;promelas;
AF126363_Pimephales_promelas	Animalia;Chordata;Actinopterygii;Cypriniformes;Cyprinidae;Pimephales;promelas;
KT289925_Pimephales_promelas	Animalia;Chordata;Actinopterygii;Cypriniformes;Cyprinidae;Pimephales;promelas;
AF126364_Pimephales_promelas	Animalia;Chordata;Actinopterygii;Cypriniformes;Cyprinidae;Pimephales;promelas;
BNM00001_Pimephales_notatus	Animalia;Chordata;Actinopterygii;Cypriniformes;Cyprinidae;Pimephales;notatus;
AY216556_Pimephales_notatus	Animalia;Chordata;Actinopterygii;Cypriniformes;Cyprinidae;Pimephales;notatus;
MG570457_Pimephales_notatus	Animalia;Chordata;Actinopterygii;Cypriniformes;Cyprinidae;Pimephales;notatus;
AF126360_Pimephales_promelas	Animalia;Chordata;Actinopterygii;Cypriniformes;Cyprinidae;Pimephales;promelas;
AP012101_Pimephales_notatus	Animalia;Chordata;Actinopterygii;Cypriniformes;Cyprinidae;Pimephales;notatus;
MG570417_Rhinichthys_obtusus	Animalia;Chordata;Actinopterygii;Cypriniformes;Cyprinidae;Rhinichthys;obtusus;
AP012105_Rhinichthys_cataractae	Animalia;Chordata;Actinopterygii;Cypriniformes;Cyprinidae;Rhinichthys;cataractae;
AF023199_Semotilus_atromaculatus	Animalia;Chordata;Actinopterygii;Cypriniformes;Cyprinidae;Semotilus;atromaculatus;
KF913024_Leuciscus_idus	Animalia;Chordata;Actinopterygii;Cypriniformes;Cyprinidae;Leuciscus;idus;
AY897013_Ctenopharyngodon_idella	Animalia;Chordata;Actinopterygii;Cypriniformes;Cyprinidae;Ctenopharyngodon;idella;
AY050550_Hypophthalmichthys_nobilis	Animalia;Chordata;Actinopterygii;Cypriniformes;Cyprinidae;Hypophthalmichthys;nobilis;
KU946955_Hypophthalmichthys_nobilis	Animalia;Chordata;Actinopterygii;Cypriniformes;Cyprinidae;Hypophthalmichthys;nobilis;
JQ231114_Hypophthalmichthys_molitrix	Animalia;Chordata;Actinopterygii;Cypriniformes;Cyprinidae;Hypophthalmichthys;molitrix;
KJ746953_Hypophthalmichthys_molitrix	Animalia;Chordata;Actinopterygii;Cypriniformes;Cyprinidae;Hypophthalmichthys;molitrix;
KU681007_Hypophthalmichthys_molitrix	Animalia;Chordata;Actinopterygii;Cypriniformes;Cyprinidae;Hypophthalmichthys;molitrix;
AP011216_Mylopharyngodon_piceus	Animalia;Chordata;Actinopterygii;Cypriniformes;Cyprinidae;Mylopharyngodon;piceus;
AB218686_Tinca_tinca	Animalia;Chordata;Actinopterygii;Cypriniformes;Cyprinidae;Tinca;tinca;
AP011263_Scardinius_erythrophthalmus	Animalia;Chordata;Actinopterygii;Cypriniformes;Cyprinidae;Scardinius;erythrophthalmus;
AF023197_Platygobio_gracilis	Animalia;Chordata;Actinopterygii;Cypriniformes;Cyprinidae;Platygobio;gracilis;
KM052222_Rhodeus_sericeus	Animalia;Chordata;Actinopterygii;Cypriniformes;Cyprinidae;Rhodeus;sericeus;
KU821714_Rhodeus_ocellatus	Animalia;Chordata;Actinopterygii;Cypriniformes;Cyprinidae;Rhodeus;ocellatus;
AF148332_Hybopsis_amblops	Animalia;Chordata;Actinopterygii;Cypriniformes;Cyprinidae;Hybopsis;amblops;
KU821712_Pseudorasbora_parva	Animalia;Chordata;Actinopterygii;Cypriniformes;Cyprinidae;Pseudorasbora;parva;
AF357585_Misgurnus_anguillicaudatus	Animalia;Chordata;Actinopterygii;Cypriniformes;Cobitidae;Misgurnus;anguillicaudatus;
EU670804_Misgurnus_anguillicaudatus	Animalia;Chordata;Actinopterygii;Cypriniformes;Cobitidae;Misgurnus;anguillicaudatus;
DQ026434_Misgurnus_anguillicaudatus	Animalia;Chordata;Actinopterygii;Cypriniformes;Cobitidae;Misgurnus;anguillicaudatus;
KY798481_Misgurnus_anguillicaudatus	Animalia;Chordata;Actinopterygii;Cypriniformes;Cobitidae;Misgurnus;anguillicaudatus;
AP011291_Misgurnus_anguillicaudatus	Animalia;Chordata;Actinopterygii;Cypriniformes;Cobitidae;Misgurnus;anguillicaudatus;
HM856629_Misgurnus_anguillicaudatus	Animalia;Chordata;Actinopterygii;Cypriniformes;Cobitidae;Misgurnus;anguillicaudatus;
MF579257_Misgurnus_anguillicaudatus	Animalia;Chordata;Actinopterygii;Cypriniformes;Cobitidae;Misgurnus;anguillicaudatus;
KC509900_Misgurnus_anguillicaudatus	Animalia;Chordata;Actinopterygii;Cypriniformes;Cobitidae;Misgurnus;anguillicaudatus;
AF333595_Catostomus_catostomus	Animalia;Chordata;Actinopterygii;Cypriniformes;Catostomidae;Catostomus;catostomus;
KP013114_Catostomus_commersonii	Animalia;Chordata;Actinopterygii;Cypriniformes;Catostomidae;Catostomus;commersonii;
AF333596_Catostomus_commersonii	Animalia;Chordata;Actinopterygii;Cypriniformes;Catostomidae;Catostomus;commersonii;
AB127394_Catostomus_commersonii	Animalia;Chordata;Actinopterygii;Cypriniformes;Catostomidae;Catostomus;commersonii;
KM282408_Erimyzon_sucetta	Animalia;Chordata;Actinopterygii;Cypriniformes;Catostomidae;Erimyzon;sucetta;
AF333606_Hypentelium_nigricans	Animalia;Chordata;Actinopterygii;Cypriniformes;Catostomidae;Hypentelium;nigricans;
KP306894_Ictiobus_cyprinellus	Animalia;Chordata;Actinopterygii;Cypriniformes;Catostomidae;Ictiobus;cyprinellus;
AB242166_Minytrema_melanops	Animalia;Chordata;Actinopterygii;Cypriniformes;Catostomidae;Minytrema;melanops;
AF333599_Minytrema_melanops	Animalia;Chordata;Actinopterygii;Cypriniformes;Catostomidae;Minytrema;melanops;
AF333600_Moxostoma_anisurum	Animalia;Chordata;Actinopterygii;Cypriniformes;Catostomidae;Moxostoma;anisurum;
AF333601_Moxostoma_carinatum	Animalia;Chordata;Actinopterygii;Cypriniformes;Catostomidae;Moxostoma;carinatum;
GOR00004_Moxostoma_erythrurum	Animalia;Chordata;Actinopterygii;Cypriniformes;Catostomidae;Moxostoma;erythrurum;
SHR00001_Moxostoma_macrolepidotum	Animalia;Chordata;Actinopterygii;Cypriniformes;Catostomidae;Moxostoma;macrolepidotum;
DQ421855_Ameiurus_melas	Animalia;Chordata;Actinopterygii;Siluriformes;Ictaluridae;Ameiurus;melas;
KT804702_Ameiurus_melas	Animalia;Chordata;Actinopterygii;Siluriformes;Ictaluridae;Ameiurus;melas;
DQ421865_Ameiurus_natalis	Animalia;Chordata;Actinopterygii;Siluriformes;Ictaluridae;Ameiurus;natalis;
MG570406_Ameiurus_natalis	Animalia;Chordata;Actinopterygii;Siluriformes;Ictaluridae;Ameiurus;natalis;
NC036387_Ameiurus_nebulosus	Animalia;Chordata;Actinopterygii;Siluriformes;Ictaluridae;Ameiurus;nebulosus;
JX899750_Ameiurus_nebulosus	Animalia;Chordata;Actinopterygii;Siluriformes;Ictaluridae;Ameiurus;nebulosus;
JN015531_Ictalurus_punctatus	Animalia;Chordata;Actinopterygii;Siluriformes;Ictaluridae;Ictalurus;punctatus;
AF482987_Ictalurus_punctatus	Animalia;Chordata;Actinopterygii;Siluriformes;Ictaluridae;Ictalurus;punctatus;
AM398435_Silurus_glanis	Animalia;Chordata;Actinopterygii;Siluriformes;Siluridae;Silurus;glanis;
JN015534_Noturus_gyrinus	Animalia;Chordata;Actinopterygii;Siluriformes;Ictaluridae;Noturus;gyrinus;
MF621727_Pylodictis_olivaris	Animalia;Chordata;Actinopterygii;Siluriformes;Ictaluridae;Pylodictis;olivaris;
GRP00001_Esox_americanus	Animalia;Chordata;Actinopterygii;Esociformes;Esocidae;Esox;americanus;
AP004103_Esox_lucius	Animalia;Chordata;Actinopterygii;Esociformes;Esocidae;Esox;lucius;
MH918123_Esox_lucius	Animalia;Chordata;Actinopterygii;Esociformes;Esocidae;Esox;lucius;
AP013046_Esox_niger	Animalia;Chordata;Actinopterygii;Esociformes;Esocidae;Esox;niger;
EMA00005_Esox_masquinongy	Animalia;Chordata;Actinopterygii;Esociformes;Esocidae;Esox;masquinongy;
KP013095_Umbra_limi	Animalia;Chordata;Actinopterygii;Esociformes;Umbridae;Umbra;limi;
HM106493_Osmerus_mordax	Animalia;Chordata;Actinopterygii;Osmeriformes;Osmeridae;Osmerus;mordax;
MF621766_Coregonus_artedi	Animalia;Chordata;Actinopterygii;Salmoniformes;Salmonidae;Coregonus;artedi;
JQ390060_Coregonus_clupeaformis	Animalia;Chordata;Actinopterygii;Salmoniformes;Salmonidae;Coregonus;clupeaformis;
MG924469_Coregonus_zenithicus	Animalia;Chordata;Actinopterygii;Salmoniformes;Salmonidae;Coregonus;zenithicus;
EF455489_Oncorhynchus_gorbuscha	Animalia;Chordata;Actinopterygii;Salmoniformes;Salmonidae;Oncorhynchus;gorbuscha;
MF621749_Oncorhynchus_kisutch	Animalia;Chordata;Actinopterygii;Salmoniformes;Salmonidae;Oncorhynchus;kisutch;
KP085590_Oncorhynchus_mykiss	Animalia;Chordata;Actinopterygii;Salmoniformes;Salmonidae;Oncorhynchus;mykiss;
AF113120_Oncorhynchus_mykiss	Animalia;Chordata;Actinopterygii;Salmoniformes;Salmonidae;Oncorhynchus;mykiss;
KP013084_Oncorhynchus_mykiss	Animalia;Chordata;Actinopterygii;Salmoniformes;Salmonidae;Oncorhynchus;mykiss;
EF055889_Oncorhynchus_nerka	Animalia;Chordata;Actinopterygii;Salmoniformes;Salmonidae;Oncorhynchus;nerka;
AF392054_Oncorhynchus_tshawytscha	Animalia;Chordata;Actinopterygii;Salmoniformes;Salmonidae;Oncorhynchus;tshawytscha;
MG924478_Prosopium_coulterii	Animalia;Chordata;Actinopterygii;Salmoniformes;Salmonidae;Prosopium;coulterii;
MG924470_Prosopium_coulterii	Animalia;Chordata;Actinopterygii;Salmoniformes;Salmonidae;Prosopium;coulterii;
MF621767_Prosopium_cylindraceum	Animalia;Chordata;Actinopterygii;Salmoniformes;Salmonidae;Prosopium;cylindraceum;
JQ390057_Salmo_trutta	Animalia;Chordata;Actinopterygii;Salmoniformes;Salmonidae;Salmo;trutta;
JQ390055_Salmo_salar	Animalia;Chordata;Actinopterygii;Salmoniformes;Salmonidae;Salmo;salar;
AM931027_Salmo_salar	Animalia;Chordata;Actinopterygii;Salmoniformes;Salmonidae;Salmo;salar;
AF133701_Salmo_salar	Animalia;Chordata;Actinopterygii;Salmoniformes;Salmonidae;Salmo;salar;
AF154850_Salvelinus_fontinalis	Animalia;Chordata;Actinopterygii;Salmoniformes;Salmonidae;Salvelinus;fontinalis;
MF621748_Salvelinus_namaycush	Animalia;Chordata;Actinopterygii;Salmoniformes;Salmonidae;Salvelinus;namaycush;
MF621742_Salvelinus_namaycush	Animalia;Chordata;Actinopterygii;Salmoniformes;Salmonidae;Salvelinus;namaycush;
AF149986_Percopsis_omiscomaycus	Animalia;Chordata;Actinopterygii;Percopsiformes;Percopsidae;Percopsis;omiscomaycus;
AF049731_Percopsis_omiscomaycus	Animalia;Chordata;Actinopterygii;Percopsiformes;Percopsidae;Percopsis;omiscomaycus;
FJ214986_Aphredoderus_sayanus	Animalia;Chordata;Actinopterygii;Percopsiformes;Aphredoderidae;Aphredoderus;sayanus;
KP644347_Lota_lota	Animalia;Chordata;Actinopterygii;Gadiformes;Lotidae;Lota;lota;
FJ445394_Fundulus_diaphanus	Animalia;Chordata;Actinopterygii;Cyprinodontiformes;Fundulidae;Fundulus;diaphanus;
KP013106_Fundulus_notatus	Animalia;Chordata;Actinopterygii;Cyprinodontiformes;Fundulidae;Fundulus;notatus;
AB445125_Culaea_inconstans	Animalia;Chordata;Actinopterygii;Gasterosteiformes;Gasterosteidae;Culaea;inconstans;
AP002944_Gasterosteus_aculeatus	Animalia;Chordata;Actinopterygii;Gasterosteiformes;Gasterosteidae;Gasterosteus;aculeatus;
KJ627919_Pungitius_pungitius	Animalia;Chordata;Actinopterygii;Gasterosteiformes;Gasterosteidae;Pungitius;pungitius;
AB445130_Pungitius_pungitius	Animalia;Chordata;Actinopterygii;Gasterosteiformes;Gasterosteidae;Pungitius;pungitius;
KT989571_Pungitius_pungitius	Animalia;Chordata;Actinopterygii;Gasterosteiformes;Gasterosteidae;Pungitius;pungitius;
KJ627922_Pungitius_pungitius	Animalia;Chordata;Actinopterygii;Gasterosteiformes;Gasterosteidae;Pungitius;pungitius;
AB445126_Apeltes_quadracus	Animalia;Chordata;Actinopterygii;Gasterosteiformes;Gasterosteidae;Apeltes;quadracus;
KP013090_Cottus_bairdii	Animalia;Chordata;Actinopterygii;Scorpaeniformes;Cottidae;Cottus;bairdii;
KM057993_Cottus_bairdii	Animalia;Chordata;Actinopterygii;Scorpaeniformes;Cottidae;Cottus;bairdii;
AB188190_Cottus_cognatus	Animalia;Chordata;Actinopterygii;Scorpaeniformes;Cottidae;Cottus;cognatus;
MG924474_Cottus_ricei	Animalia;Chordata;Actinopterygii;Scorpaeniformes;Cottidae;Cottus;ricei;
KU641485_Morone_americana	Animalia;Chordata;Actinopterygii;Perciformes;Moronidae;Morone;americana;
AY372812_Morone_chrysops	Animalia;Chordata;Actinopterygii;Perciformes;Moronidae;Morone;chrysops;
AF150005_Morone_chrysops	Animalia;Chordata;Actinopterygii;Perciformes;Moronidae;Morone;chrysops;
RKB00004_Ambloplites_rupestris	Animalia;Chordata;Actinopterygii;Perciformes;Centrarchidae;Ambloplites;rupestris;
KY660677_Ambloplites_rupestris	Animalia;Chordata;Actinopterygii;Perciformes;Centrarchidae;Ambloplites;rupestris;
KP013087_Lepomis_cyanellus	Animalia;Chordata;Actinopterygii;Perciformes;Centrarchidae;Lepomis;cyanellus;
KP013097_Lepomis_gibbosus	Animalia;Chordata;Actinopterygii;Perciformes;Centrarchidae;Lepomis;gibbosus;
MF621726_Lepomis_gibbosus	Animalia;Chordata;Actinopterygii;Perciformes;Centrarchidae;Lepomis;gibbosus;
KM282425_Lepomis_gulosus	Animalia;Chordata;Actinopterygii;Perciformes;Centrarchidae;Lepomis;gulosus;
AY372810_Lepomis_humilis	Animalia;Chordata;Actinopterygii;Perciformes;Centrarchidae;Lepomis;humilis;
AP005993_Lepomis_macrochirus	Animalia;Chordata;Actinopterygii;Perciformes;Centrarchidae;Lepomis;macrochirus;
AF150004_Lepomis_macrochirus	Animalia;Chordata;Actinopterygii;Perciformes;Centrarchidae;Lepomis;macrochirus;
KM370981_Lepomis_megalotis	Animalia;Chordata;Actinopterygii;Perciformes;Centrarchidae;Lepomis;megalotis;
RSF00001_Lepomis_microlophus	Animalia;Chordata;Actinopterygii;Perciformes;Centrarchidae;Lepomis;microlophus;
AB378750_Micropterus_dolomieu	Animalia;Chordata;Actinopterygii;Perciformes;Centrarchidae;Micropterus;dolomieu;
DQ536425_Micropterus_salmoides	Animalia;Chordata;Actinopterygii;Perciformes;Centrarchidae;Micropterus;salmoides;
AP014537_Micropterus_salmoides	Animalia;Chordata;Actinopterygii;Perciformes;Centrarchidae;Micropterus;salmoides;
KP013112_Pomoxis_nigromaculatus	Animalia;Chordata;Actinopterygii;Perciformes;Centrarchidae;Pomoxis;nigromaculatus;
U90403_Zoarces_viviparus	Animalia;Chordata;Actinopterygii;Perciformes;Zoarcidae;Zoarces;viviparus;
AY372766_Ammocrypta_pellucida	Animalia;Chordata;Actinopterygii;Perciformes;Percidae;Ammocrypta;pellucida;
AY372771_Etheostoma_blennioides	Animalia;Chordata;Actinopterygii;Perciformes;Percidae;Etheostoma;blennioides;
AY372773_Etheostoma_caeruleum	Animalia;Chordata;Actinopterygii;Perciformes;Percidae;Etheostoma;caeruleum;
KY660678_Etheostoma_caeruleum	Animalia;Chordata;Actinopterygii;Perciformes;Percidae;Etheostoma;caeruleum;
KM282411_Etheostoma_exile	Animalia;Chordata;Actinopterygii;Perciformes;Percidae;Etheostoma;exile;
MH301060_Etheostoma_flabellare	Animalia;Chordata;Actinopterygii;Perciformes;Percidae;Etheostoma;flabellare;
AY372781_Etheostoma_nigrum	Animalia;Chordata;Actinopterygii;Perciformes;Percidae;Etheostoma;nigrum;
KT289926_Etheostoma_nigrum	Animalia;Chordata;Actinopterygii;Perciformes;Percidae;Etheostoma;nigrum;
AY372790_Etheostoma_spectabile	Animalia;Chordata;Actinopterygii;Perciformes;Percidae;Etheostoma;spectabile;
AP005994_Etheostoma_zonale	Animalia;Chordata;Actinopterygii;Perciformes;Percidae;Etheostoma;zonale;
JX629446_Perca_flavescens	Animalia;Chordata;Actinopterygii;Perciformes;Percidae;Perca;flavescens;
AY372797_Percina_caprodes	Animalia;Chordata;Actinopterygii;Perciformes;Percidae;Percina;caprodes;
AY372798_Percina_copelandi	Animalia;Chordata;Actinopterygii;Perciformes;Percidae;Percina;copelandi;
AY372801_Percina_maculata	Animalia;Chordata;Actinopterygii;Perciformes;Percidae;Percina;maculata;
BSC00001_Percina_maculata	Animalia;Chordata;Actinopterygii;Perciformes;Percidae;Percina;maculata;
KP013098_Sander_vitreus	Animalia;Chordata;Actinopterygii;Perciformes;Percidae;Sander;vitreus;
KT211445_Sander_vitreus	Animalia;Chordata;Actinopterygii;Perciformes;Percidae;Sander;vitreus;
KC663435_Sander_canadensis	Animalia;Chordata;Actinopterygii;Perciformes;Percidae;Sander;canadensis;
KT211477_Sander_canadensis	Animalia;Chordata;Actinopterygii;Perciformes;Percidae;Sander;canadensis;
AY372807_Sander_canadensis	Animalia;Chordata;Actinopterygii;Perciformes;Percidae;Sander;canadensis;
AY372808_Sander_lucioperca	Animalia;Chordata;Actinopterygii;Perciformes;Percidae;Sander;lucioperca;
KM410087_Sander_lucioperca	Animalia;Chordata;Actinopterygii;Perciformes;Percidae;Sander;lucioperca;
KM978956_Gymnocephalus_cernua	Animalia;Chordata;Actinopterygii;Perciformes;Percidae;Gymnocephalus;cernua;
MH918137_Gymnocephalus_cernua	Animalia;Chordata;Actinopterygii;Perciformes;Percidae;Gymnocephalus;cernua;
FWD00001_Aplodinotus_grunniens	Animalia;Chordata;Actinopterygii;Perciformes;Sciaenidae;Aplodinotus;grunniens;
RGY00001_Neogobius_melanostomus	Animalia;Chordata;Actinopterygii;Gobiiformes;Gobiidae;Neogobius;melanostomus;
AF150003_Gambusia_affinis	Animalia;Chordata;Actinopterygii;Cyprinodontiformes;Poeciliidae;Gambusia;affinis;
KU946956_Gambusia_affinis	Animalia;Chordata;Actinopterygii;Cyprinodontiformes;Poeciliidae;Gambusia;affinis;
AP004422_Gambusia_affinis	Animalia;Chordata;Actinopterygii;Cyprinodontiformes;Poeciliidae;Gambusia;affinis;
KU852433_Channa_argus	Animalia;Chordata;Actinopterygii;Anabantiformes;Channidae;Channa;argus;
GU937112_Channa_argus	Animalia;Chordata;Actinopterygii;Anabantiformes;Channidae;Channa;argus;
JN315625_Ondatra_zibethicus	Animalia;Chordata;Mammalia;Rodentia;Cricetidae;Ondatra;zibethicus;
KU177045_Ondatra_zibethicus	Animalia;Chordata;Mammalia;Rodentia;Cricetidae;Ondatra;zibethicus;
AY012091_Didelphis_virginiana	Animalia;Chordata;Mammalia;Didelphimorphia;Didelphidae;Didelphis;virginiana;
AY012111_Castor_canadensis	Animalia;Chordata;Mammalia;Rodentia;Castoridae;Castor;canadensis;
KM612278_Odocoileus_virginianus	Animalia;Chordata;Mammalia;Artiodactyla;Cervidae;Odocoileus;virginianus;
KM612279_Odocoileus_virginianus	Animalia;Chordata;Mammalia;Artiodactyla;Cervidae;Odocoileus;virginianus;
KM612276_Odocoileus_virginianus	Animalia;Chordata;Mammalia;Artiodactyla;Cervidae;Odocoileus;virginianus;
JN632673_Odocoileus_virginianus	Animalia;Chordata;Mammalia;Artiodactyla;Cervidae;Odocoileus;virginianus;
MG674648_Peromyscus_leucopus	Animalia;Chordata;Mammalia;Rodentia;Cricetidae;Peromyscus;leucopus;
J01438_Rattus_norvegicus	Animalia;Chordata;Mammalia;Rodentia;Muridae;Rattus;norvegicus;
KM114606_Rattus_norvegicus	Animalia;Chordata;Mammalia;Rodentia;Muridae;Rattus;norvegicus;
AY012118_Erethizon_dorsatum	Animalia;Chordata;Mammalia;Rodentia;Erethizontidae;Erethizon;dorsatum;
AF520694_Erethizon_dorsatum	Animalia;Chordata;Mammalia;Rodentia;Erethizontidae;Erethizon;dorsatum;
JN113040_Sciurus_carolinensis	Animalia;Chordata;Mammalia;Rodentia;Sciuridae;Sciurus;carolinensis;
U59174_Sciurus_niger	Animalia;Chordata;Mammalia;Rodentia;Sciuridae;Sciurus;niger;
KY070151_Tamias_striatus	Animalia;Chordata;Mammalia;Rodentia;Sciuridae;Tamias;striatus;
HM106330_Taxidea_taxus	Animalia;Chordata;Mammalia;Carnivora;Mustelidae;Taxidea;taxus;
HM106324_Martes_americana	Animalia;Chordata;Mammalia;Carnivora;Mustelidae;Martes;americana;
HQ705179_Martes_pennanti	Animalia;Chordata;Mammalia;Carnivora;Mustelidae;Martes;pennanti;
KR611313_Gulo_gulo	Animalia;Chordata;Mammalia;Carnivora;Mustelidae;Gulo;gulo;
KU146454_Neovison_vison	Animalia;Chordata;Mammalia;Carnivora;Mustelidae;Neovison;vison;
KM091450_Mustela_erminea	Animalia;Chordata;Mammalia;Carnivora;Mustelidae;Mustela;erminea;
HM106321_Mustela_frenata	Animalia;Chordata;Mammalia;Carnivora;Mustelidae;Mustela;frenata;
M95110_Blarina_brevicauda	Animalia;Chordata;Mammalia;Eulipotyphla;Soricidae;Blarina;brevicauda;
AY691825_Sorex_cinereus	Animalia;Chordata;Mammalia;Eulipotyphla;Soricidae;Sorex;cinereus;
U97343_Sorex_palustris	Animalia;Chordata;Mammalia;Eulipotyphla;Soricidae;Sorex;palustris;
KX754498_Scalopus_aquaticus	Animalia;Chordata;Mammalia;Eulipotyphla;Talpidae;Scalopus;aquaticus;
KU144678_Condylura_cristata	Animalia;Chordata;Mammalia;Eulipotyphla;Talpidae;Condylura;cristata;
AB297804_Procyon_lotor	Animalia;Chordata;Mammalia;Carnivora;Procyonidae;Procyon;lotor;
KT448277_Canis_latrans	Animalia;Chordata;Mammalia;Carnivora;Canidae;Canis;latrans;
DQ480510_Canis_latrans	Animalia;Chordata;Mammalia;Carnivora;Canidae;Canis;latrans;
KU696388_Canis_lupus	Animalia;Chordata;Mammalia;Carnivora;Canidae;Canis;lupus;
AB499816_Canis_familiaris	Animalia;Chordata;Mammalia;Carnivora;Canidae;Canis;familiaris;
JN711443_Vulpes_vulpes	Animalia;Chordata;Mammalia;Carnivora;Canidae;Vulpes;vulpes;
KF387633_Vulpes_vulpes	Animalia;Chordata;Mammalia;Carnivora;Canidae;Vulpes;vulpes;
AY012149_Felis_catus	Animalia;Chordata;Mammalia;Carnivora;Felidae;Felis;catus;
U20753_Felis_catus	Animalia;Chordata;Mammalia;Carnivora;Felidae;Felis;catus;
GQ979707_Lynx_rufus	Animalia;Chordata;Mammalia;Carnivora;Felidae;Lynx;rufus;
KP202281_Lynx_canadensis	Animalia;Chordata;Mammalia;Carnivora;Felidae;Lynx;canadensis;
GU174608_Lynx_canadensis	Animalia;Chordata;Mammalia;Carnivora;Felidae;Lynx;canadensis;
AF303109_Ursus_americanus	Animalia;Chordata;Mammalia;Carnivora;Ursidae;Ursus;americanus;
MF143474_Eptesicus_fuscus	Animalia;Chordata;Mammalia;Chiroptera;Vespertilionidae;Eptesicus;fuscus;
U61082_Eptesicus_fuscus	Animalia;Chordata;Mammalia;Chiroptera;Vespertilionidae;Eptesicus;fuscus;
AF326092_Eptesicus_fuscus	Animalia;Chordata;Mammalia;Chiroptera;Vespertilionidae;Eptesicus;fuscus;
HM106332_Mephitis_mephitis	Animalia;Chordata;Mammalia;Carnivora;Mephitidae;Mephitis;mephitis;
AY012126_Sylvilagus_floridanus	Animalia;Chordata;Mammalia;Lagomorpha;Leporidae;Sylvilagus;floridanus;
KU057218_Sylvilagus_floridanus	Animalia;Chordata;Mammalia;Lagomorpha;Leporidae;Sylvilagus;floridanus;
U58929_Sylvilagus_floridanus	Animalia;Chordata;Mammalia;Lagomorpha;Leporidae;Sylvilagus;floridanus;
KU057246_Sylvilagus_floridanus	Animalia;Chordata;Mammalia;Lagomorpha;Leporidae;Sylvilagus;floridanus;
KU057244_Sylvilagus_floridanus	Animalia;Chordata;Mammalia;Lagomorpha;Leporidae;Sylvilagus;floridanus;
AY227529_Marmota_monax	Animalia;Chordata;Mammalia;Rodentia;Sciuridae;Marmota;monax;
KJ397613_Lepus_americanus	Animalia;Chordata;Mammalia;Lagomorpha;Leporidae;Lepus;americanus;
AY012136_Homo_sapiens	Animalia;Chordata;Mammalia;Primates;Hominidae;Homo;sapiens;
KP222281_Rana_sylvatica	Animalia;Chordata;Amphibia;Anura;Ranidae;Rana;sylvatica;
DQ283387_Rana_sylvatica	Animalia;Chordata;Amphibia;Anura;Ranidae;Rana;sylvatica;
KX686108_Rana_catesbeiana	Animalia;Chordata;Amphibia;Anura;Ranidae;Rana;catesbeiana;
Y10945_Rana_pipiens	Animalia;Chordata;Amphibia;Anura;Ranidae;Rana;pipiens;
DQ283185_Rana_clamitans	Animalia;Chordata;Amphibia;Anura;Ranidae;Rana;clamitans;
AY291116_Hyla_chrysoscelis	Animalia;Chordata;Amphibia;Anura;Hylidae;Hyla;chrysoscelis;
AY843682_Hyla_versicolor	Animalia;Chordata;Amphibia;Anura;Hylidae;Hyla;versicolor;
EF472007_Pseudacris_crucifer	Animalia;Chordata;Amphibia;Anura;Hylidae;Pseudacris;crucifer;
AY291099_Pseudacris_crucifer_crucifer	Animalia;Chordata;Amphibia;Anura;Hylidae;Pseudacris;crucifer_crucifer;
AY291101_Pseudacris_crucifer_crucifer	Animalia;Chordata;Amphibia;Anura;Hylidae;Pseudacris;crucifer_crucifer;
AY291102_Pseudacris_crucifer_crucifer	Animalia;Chordata;Amphibia;Anura;Hylidae;Pseudacris;crucifer_crucifer;
EF472158_Pseudacris_triseriata	Animalia;Chordata;Amphibia;Anura;Hylidae;Pseudacris;triseriata;
EF472144_Pseudacris_triseriata	Animalia;Chordata;Amphibia;Anura;Hylidae;Pseudacris;triseriata;
AY843738_Pseudacris_triseriata	Animalia;Chordata;Amphibia;Anura;Hylidae;Pseudacris;triseriata;
AY843559_Acris_crepitans	Animalia;Chordata;Amphibia;Anura;Hylidae;Acris;crepitans;
EF566970_Acris_crepitans	Animalia;Chordata;Amphibia;Anura;Hylidae;Acris;crepitans;
AY819360_Acris_crepitans	Animalia;Chordata;Amphibia;Anura;Hylidae;Acris;crepitans;
EF472134_Pseudacris_maculata	Animalia;Chordata;Amphibia;Anura;Hylidae;Pseudacris;maculata;
EF472122_Pseudacris_maculata	Animalia;Chordata;Amphibia;Anura;Hylidae;Pseudacris;maculata;
EF532235_Bufo_americanus	Animalia;Chordata;Amphibia;Anura;Bufonidae;Bufo;americanus;
DQ158426_Bufo_americanus	Animalia;Chordata;Amphibia;Anura;Bufonidae;Bufo;americanus;
DQ158451_Bufo_fowleri	Animalia;Chordata;Amphibia;Anura;Bufonidae;Bufo;fowleri;
AY680224_Bufo_fowleri	Animalia;Chordata;Amphibia;Anura;Bufonidae;Bufo;fowleri;
AY680212_Bufo_fowleri	Animalia;Chordata;Amphibia;Anura;Bufonidae;Bufo;fowleri;
GU078471_Ambystoma_texanum	Animalia;Chordata;Amphibia;Caudata;Ambystomatidae;Ambystoma;texanum;
AY659992_Ambystoma_tigrinum	Animalia;Chordata;Amphibia;Caudata;Ambystomatidae;Ambystoma;tigrinum;
AY728218_Ambystoma_laterale	Animalia;Chordata;Amphibia;Caudata;Ambystomatidae;Ambystoma;laterale;
EU880323_Notophthalmus_viridescens	Animalia;Chordata;Amphibia;Caudata;Salamandridae;Notophthalmus;viridescens;
U71241_Desmognathus_fuscus	Animalia;Chordata;Amphibia;Caudata;Plethodontidae;Desmognathus;fuscus;
AY728227_Desmognathus_fuscus	Animalia;Chordata;Amphibia;Caudata;Plethodontidae;Desmognathus;fuscus;
AY728217_Eurycea_bislineata	Animalia;Chordata;Amphibia;Caudata;Plethodontidae;Eurycea;bislineata;
KY885249_Eurycea_cirrigera	Animalia;Chordata;Amphibia;Caudata;Plethodontidae;Eurycea;cirrigera;
AY728230_Gyrinophilus_porphyriticus	Animalia;Chordata;Amphibia;Caudata;Plethodontidae;Gyrinophilus;porphyriticus;
EU336398_Gyrinophilus_porphyriticus	Animalia;Chordata;Amphibia;Caudata;Plethodontidae;Gyrinophilus;porphyriticus;
EU336428_Gyrinophilus_porphyriticus	Animalia;Chordata;Amphibia;Caudata;Plethodontidae;Gyrinophilus;porphyriticus;
EU336418_Gyrinophilus_porphyriticus	Animalia;Chordata;Amphibia;Caudata;Plethodontidae;Gyrinophilus;porphyriticus;
EU336432_Gyrinophilus_porphyriticus	Animalia;Chordata;Amphibia;Caudata;Plethodontidae;Gyrinophilus;porphyriticus;
EU336393_Gyrinophilus_porphyriticus	Animalia;Chordata;Amphibia;Caudata;Plethodontidae;Gyrinophilus;porphyriticus;
AY728231_Hemidactylium_scutatum	Animalia;Chordata;Amphibia;Caudata;Plethodontidae;Hemidactylium;scutatum;
EU427931_Plethodon_glutinosus	Animalia;Chordata;Amphibia;Caudata;Plethodontidae;Plethodon;glutinosus;
EU427928_Plethodon_glutinosus	Animalia;Chordata;Amphibia;Caudata;Plethodontidae;Plethodon;glutinosus;
AY728232_Plethodon_cinereus	Animalia;Chordata;Amphibia;Caudata;Plethodontidae;Plethodon;cinereus;
MH888024_Siren_intermedia	Animalia;Chordata;Amphibia;Caudata;Sirenidae;Siren;intermedia;
GQ368661_Siren_intermedia	Animalia;Chordata;Amphibia;Caudata;Sirenidae;Siren;intermedia;
Y10946_Siren_intermedia	Animalia;Chordata;Amphibia;Caudata;Sirenidae;Siren;intermedia;
MH888029_Siren_intermedia	Animalia;Chordata;Amphibia;Caudata;Sirenidae;Siren;intermedia;
KM282431+DQ283412_Necturus_maculosus	Animalia;Chordata;Amphibia;Caudata; Proteidae;Necturus;maculosus;
EF122793_Chelydra_serpentina	Animalia;Chordata;Reptilia;Testudines;Chelydridae;Chelydra;serpentina;
AF069423_Chrysemys_picta	Animalia;Chordata;Reptilia;Testudines;Emydidae;Chrysemys;picta;
KM216748_Trachemys_scripta	Animalia;Chordata;Reptilia;Testudines;Emydidae;Trachemys;scripta;
JF966197_Apalone_spinifera	Animalia;Chordata;Reptilia;Testudines;Trionychidae;Apalone;spinifera;
GU477764_Mauremys_reevesii	Animalia;Chordata;Reptilia;Testudines;Geoemydidae;Mauremys;reevesii;
JN860637_Graptemys_pseudogeographica	Animalia;Chordata;Reptilia;Testudines;Emydidae;Graptemys;pseudogeographica;
KF874616_Chrysemys_picta_bellii	Animalia;Chordata;Reptilia;Testudines;Emydidae;Chrysemys;picta_bellii;
KM216748_Trachemys_scripta_elegans	Animalia;Chordata;Reptilia;Testudines;Emydidae;Trachemys;scripta_elegans;
KM216749_Trachemys_scripta_scripta	Animalia;Chordata;Reptilia;Testudines;Emydidae;Trachemys;scripta_scripta;
JF964960_Nerodia_sipedon	Animalia;Chordata;Reptilia;Squamata;Colubridae;Nerodia;sipedon;
AF402629_Nerodia_erythrogaster	Animalia;Chordata;Reptilia;Squamata;Colubridae;Nerodia;erythrogaster;
AF402640_Thamnophis_butleri	Animalia;Chordata;Reptilia;Squamata;Colubridae;Thamnophis;butleri;
AF402651_Thamnophis_radix	Animalia;Chordata;Reptilia;Squamata;Colubridae;Thamnophis;radix;
KX694574_Thamnophis_sirtalis	Animalia;Chordata;Reptilia;Squamata;Colubridae;Thamnophis;sirtalis;
AY122819_Coluber_constrictor	Animalia;Chordata;Reptilia;Squamata;Colubridae;Coluber;constrictor;
AY122667_Coluber_constrictor	Animalia;Chordata;Reptilia;Squamata;Colubridae;Coluber;constrictor;
HM641837_Crotalus_horridus	Animalia;Chordata;Reptilia;Squamata;Viperidae;Crotalus;horridus;
FJ623963_Lampropeltis_triangulum	Animalia;Chordata;Reptilia;Squamata;Colubridae;Lampropeltis;triangulum;
AY122818_Pantherophis_vulpinus	Animalia;Chordata;Reptilia;Squamata;Colubridae;Pantherophis;vulpinus;
AY122817_Pantherophis_vulpinus	Animalia;Chordata;Reptilia;Squamata;Colubridae;Pantherophis;vulpinus;
AY122844_Pantherophis_obsoletus	Animalia;Chordata;Reptilia;Squamata;Colubridae;Pantherophis;obsoletus;
AF402639_Storeria_dekayi	Animalia;Chordata;Reptilia;Squamata;Colubridae;Storeria;dekayi;
AF402638_Storeria_occipitomaculata	Animalia;Chordata;Reptilia;Squamata;Colubridae;Storeria;occipitomaculata;
AY315505_Plestiodon_fasciatus	Animalia;Chordata;Reptilia;Squamata;Scincidae;Plestiodon;fasciatus;
AF173562_Picoides_pubescens	Animalia;Chordata;Aves;Piciformes;Picidae;Picoides;pubescens;
EU372668_Colaptes_auratus	Animalia;Chordata;Aves;Piciformes;Picidae;Colaptes;auratus;
AF447248_Pheucticus_ludovicianus	Animalia;Chordata;Aves;Passeriformes;Cardinalidae;Pheucticus;ludovicianus;
HM159163_Sturnus_vulgaris	Animalia;Chordata;Aves;Passeriformes;Sturnidae;Sturnus;vulgaris;
AF173599_Turdus_migratorius	Animalia;Chordata;Aves;Passeriformes;Turdidae;Turdus;migratorius;
DQ019124_Branta_canadensis	Animalia;Chordata;Aves;Anseriformes;Anatidae;Branta;canadensis;
EU009397_Anas_platyrhynchos	Animalia;Chordata;Aves;Anseriformes;Anatidae;Anas;platyrhynchos;
L22478_Anas_platyrhynchos	Animalia;Chordata;Aves;Anseriformes;Anatidae;Anas;platyrhynchos;
L16770_Anas_platyrhynchos	Animalia;Chordata;Aves;Anseriformes;Anatidae;Anas;platyrhynchos;
U59666_Anas_platyrhynchos	Animalia;Chordata;Aves;Anseriformes;Anatidae;Anas;platyrhynchos;
KX902235_Zenaida_macroura	Animalia;Chordata;Aves;Columbiformes;Columbidae;Zenaida;macroura;
EF153719_Meleagris_gallopavo	Animalia;Chordata;Aves;Galliformes;Phasianidae;Meleagris;gallopavo;
EF532935_Archilochus_colubris	Animalia;Chordata;Aves;Apodiformes;Trochilidae;Archilochus;colubris;
AF173567_Podiceps_auritus	Animalia;Chordata;Aves;Podicipediformes;Podicipedidae;Podiceps;auritus;
EU167037_Chordeiles_minor	Animalia;Chordata;Aves;Caprimulgiformes;Caprimulgidae;Chordeiles;minor;
KT809406_Chaetura_pelagica	Animalia;Chordata;Aves;Apodiformes;Apodidae;Chaetura;pelagica;
AF173582_Coccyzus_americanus	Animalia;Chordata;Aves;Cuculiformes;Cuculidae;Coccyzus;americanus;
EU167074_Fulica_americana	Animalia;Chordata;Aves;Gruiformes;Rallidae;Fulica;americana;
FJ769855_Antigone_canadensis	Animalia;Chordata;Aves;Gruiformes;Gruidae;Antigone;canadensis;
AF173577_Gavia_immer	Animalia;Chordata;Aves;Gaviiformes;Gaviidae;Gavia;immer;
DQ485799_Botaurus_lentiginosus	Animalia;Chordata;Aves;Pelecaniformes;Ardeidae;Botaurus;lentiginosus;
KJ722534_Bubulcus_ibis	Animalia;Chordata;Aves;Pelecaniformes;Ardeidae;Bubulcus;ibis;
KJ190945_Bubulcus_ibis	Animalia;Chordata;Aves;Pelecaniformes;Ardeidae;Bubulcus;ibis;
DQ485800_Bubulcus_ibis	Animalia;Chordata;Aves;Pelecaniformes;Ardeidae;Bubulcus;ibis;
DQ485792_Charadrius_vociferus	Animalia;Chordata;Aves;Charadriiformes;Charadriidae;Charadrius;vociferus;
EF373108_Scolopax_minor	Animalia;Chordata;Aves;Charadriiformes;Scolopacidae;Scolopax;minor;
MF582632_Sterna_hirundo	Animalia;Chordata;Aves;Charadriiformes;Laridae;Sterna;hirundo;
MG916810_Asio_otus	Animalia;Chordata;Aves;Strigiformes;Strigidae;Asio;otus;
AY463690_Cathartes_aura	Animalia;Chordata;Aves;Accipitriformes;Cathartidae;Cathartes;aura;
DQ780884_Pandion_haliaetus	Animalia;Chordata;Aves;Accipitriformes;Pandionidae;Pandion;haliaetus;
EU167063_Pandion_haliaetus	Animalia;Chordata;Aves;Accipitriformes;Pandionidae;Pandion;haliaetus;
GQ264618_Buteo_jamaicensis	Animalia;Chordata;Aves;Accipitriformes;Accipitridae;Buteo;jamaicensis;
EU167039_Megaceryle_alcyon	Animalia;Chordata;Aves;Coraciiformes;Alcedinidae;Megaceryle;alcyon;
KT119343_Picoides_pubescens	Animalia;Chordata;Aves;Piciformes;Picidae;Picoides;pubescens;
DQ780880_Falco_sparverius	Animalia;Chordata;Aves;Falconiformes;Falconidae;Falco;sparverius;
KP403809_Corvus_brachyrhynchos	Animalia;Chordata;Aves;Passeriformes;Corvidae;Corvus;brachyrhynchos;
AF173600_Tyrannus_tyrannus	Animalia;Chordata;Aves;Passeriformes;Tyrannidae;Tyrannus;tyrannus;
KJ909193_Vireo_olivaceus	Animalia;Chordata;Aves;Passeriformes;Vireonidae;Vireo;olivaceus;
KJ909190_Poecile_atricapilla	Animalia;Chordata;Aves;Passeriformes;Paridae;Poecile;atricapilla;
KX398931_Hirundo_rustica	Animalia;Chordata;Aves;Passeriformes;Hirundinidae;Hirundo;rustica;
KJ909195_Sitta_carolinensis	Animalia;Chordata;Aves;Passeriformes;Sittidae;Sitta;carolinensis;
KM078782_Haemorhous_mexicanus	Animalia;Chordata;Aves;Passeriformes;Fringillidae;Haemorhous;mexicanus;
FJ236300_Haemorhous_mexicanus	Animalia;Chordata;Aves;Passeriformes;Fringillidae;Haemorhous;mexicanus;
FJ236301_Spinus_tristis	Animalia;Chordata;Aves;Passeriformes;Fringillidae;Spinus;tristis;
AF447238_Junco_hyemalis	Animalia;Chordata;Aves;Passeriformes;Passerellidae;Junco;hyemalis;
FJ236289_Agelaius_phoeniceus	Animalia;Chordata;Aves;Passeriformes;Icteridae;Agelaius;phoeniceus;
AF447241_Molothrus_ater	Animalia;Chordata;Aves;Passeriformes;Icteridae;Molothrus;ater;
JX516064_Quiscalus_quiscula	Animalia;Chordata;Aves;Passeriformes;Icteridae;Quiscalus;quiscula;
AF447233_Geothlypis_trichas	Animalia;Chordata;Aves;Passeriformes;Parulidae;Geothlypis;trichas;
KM078795_Cardinalis_cardinalis	Animalia;Chordata;Aves;Passeriformes;Cardinalidae;Cardinalis;cardinalis;
