KJ128854_Petromyzon_marinus	Animalia;Chordata;Hyperoartia;Petromyzontiformes;Petromyzontidae;Petromyzon;marinus;
KM267717_Ichthyomyzon_unicuspis	Animalia;Chordata;Hyperoartia;Petromyzontiformes;Petromyzontidae;Ichthyomyzon;unicuspis;
KM267716_Ichthyomyzon_fossor	Animalia;Chordata;Hyperoartia;Petromyzontiformes;Petromyzontidae;Ichthyomyzon;fossor;
KM267719_Lampetra_appendix	Animalia;Chordata;Hyperoartia;Petromyzontiformes;Petromyzontidae;Lampetra;appendix;
AF004954_Acipenser_fulvescens	Animalia;Chordata;Actinopterygii;Acipenseriformes;Acipenseridae;Acipenser;fulvescens;
KU985086_Polyodon_spathula	Animalia;Chordata;Actinopterygii;Acipenseriformes;Polyodontidae;Polyodon;spathula;
AP004353_Polyodon_spathula	Animalia;Chordata;Actinopterygii;Acipenseriformes;Polyodontidae;Polyodon;spathula;
JF912023_Lepisosteus_osseus	Animalia;Chordata;Actinopterygii;Lepisosteiformes;Lepisosteidae;Lepisosteus;osseus;
DQ536423_Lepisosteus_osseus	Animalia;Chordata;Actinopterygii;Lepisosteiformes;Lepisosteidae;Lepisosteus;osseus;
JX845309_Lepisosteus_osseus	Animalia;Chordata;Actinopterygii;Lepisosteiformes;Lepisosteidae;Lepisosteus;osseus;
AB042861_Lepisosteus_oculatus	Animalia;Chordata;Actinopterygii;Lepisosteiformes;Lepisosteidae;Lepisosteus;oculatus;
JF912019_Lepisosteus_oculatus	Animalia;Chordata;Actinopterygii;Lepisosteiformes;Lepisosteidae;Lepisosteus;oculatus;
AY442347_Amia_calva	Animalia;Chordata;Actinopterygii;Amiiformes;Amiidae;Amia;calva;
AB042952_Amia_calva	Animalia;Chordata;Actinopterygii;Amiiformes;Amiidae;Amia;calva;
AP009499_Hiodon_tergisus	Animalia;Chordata;Actinopterygii;Hiodontiformes;Hiodontidae;Hiodon;tergisus;
KJ564271_Anguilla_rostrata	Animalia;Chordata;Actinopterygii;Anguilliformes;Anguillidae;Anguilla;rostrata;
KJ564193_Anguilla_rostrata	Animalia;Chordata;Actinopterygii;Anguilliformes;Anguillidae;Anguilla;rostrata;
KJ564175_Anguilla_rostrata	Animalia;Chordata;Actinopterygii;Anguilliformes;Anguillidae;Anguilla;rostrata;
KJ564207_Anguilla_rostrata	Animalia;Chordata;Actinopterygii;Anguilliformes;Anguillidae;Anguilla;rostrata;
KJ564198_Anguilla_rostrata	Animalia;Chordata;Actinopterygii;Anguilliformes;Anguillidae;Anguilla;rostrata;
X99183_Anguilla_rostrata	Animalia;Chordata;Actinopterygii;Anguilliformes;Anguillidae;Anguilla;rostrata;
AP009132_Alosa_pseudoharengus	Animalia;Chordata;Actinopterygii;Clupeiformes;Clupeidae;Alosa;pseudoharengus;
DQ912081_Alosa_chrysochloris	Animalia;Chordata;Actinopterygii;Clupeiformes;Clupeidae;Alosa;chrysochloris;
NC037017_Alosa_aestivalis	Animalia;Chordata;Actinopterygii;Clupeiformes;Clupeidae;Alosa;aestivalis;
DQ912076_Alosa_aestivalis	Animalia;Chordata;Actinopterygii;Clupeiformes;Clupeidae;Alosa;aestivalis;
KY769128_Alosa_sapidissima	Animalia;Chordata;Actinopterygii;Clupeiformes;Clupeidae;Alosa;sapidissima;
DQ536426_Dorosoma_cepedianum	Animalia;Chordata;Actinopterygii;Clupeiformes;Clupeidae;Dorosoma;cepedianum;
MG570429_Dorosoma_cepedianum	Animalia;Chordata;Actinopterygii;Clupeiformes;Clupeidae;Dorosoma;cepedianum;
DQ912062_Dorosoma_cepedianum	Animalia;Chordata;Actinopterygii;Clupeiformes;Clupeidae;Dorosoma;cepedianum;
AF081839_Campostoma_anomalum	Animalia;Chordata;Actinopterygii;Cypriniformes;Cyprinidae;Campostoma;anomalum;
MT471948_Campostoma_anomalum	Animalia;Chordata;Actinopterygii;Cypriniformes;Cyprinidae;Campostoma;anomalum;
MT471845_Campostoma_anomalum	Animalia;Chordata;Actinopterygii;Cypriniformes;Cyprinidae;Campostoma;anomalum;
DQ536421_Campostoma_anomalum	Animalia;Chordata;Actinopterygii;Cypriniformes;Cyprinidae;Campostoma;anomalum;
MH161806_Carassius_auratus	Animalia;Chordata;Actinopterygii;Cypriniformes;Cyprinidae;Carassius;auratus;
KM657136_Carassius_auratus	Animalia;Chordata;Actinopterygii;Cypriniformes;Cyprinidae;Carassius;auratus;
JN105355_Carassius_auratus	Animalia;Chordata;Actinopterygii;Cypriniformes;Cyprinidae;Carassius;auratus;
KJ874431_Carassius_auratus	Animalia;Chordata;Actinopterygii;Cypriniformes;Cyprinidae;Carassius;auratus;
AP011236_Carassius_auratus	Animalia;Chordata;Actinopterygii;Cypriniformes;Cyprinidae;Carassius;auratus;
KY231826_Carassius_auratus	Animalia;Chordata;Actinopterygii;Cypriniformes;Cyprinidae;Carassius;auratus;
LC097874_Carassius_auratus	Animalia;Chordata;Actinopterygii;Cypriniformes;Cyprinidae;Carassius;auratus;
LC097875_Carassius_auratus	Animalia;Chordata;Actinopterygii;Cypriniformes;Cyprinidae;Carassius;auratus;
LC097881_Carassius_auratus	Animalia;Chordata;Actinopterygii;Cypriniformes;Cyprinidae;Carassius;auratus;
LC097877_Carassius_auratus	Animalia;Chordata;Actinopterygii;Cypriniformes;Cyprinidae;Carassius;auratus;
AP011280_Clinostomus_elongatus	Animalia;Chordata;Actinopterygii;Cypriniformes;Cyprinidae;Clinostomus;elongatus;
AP011274_Couesius_plumbeus	Animalia;Chordata;Actinopterygii;Cypriniformes;Cyprinidae;Couesius;plumbeus;
CSP00020_Cyprinella_spiloptera	Animalia;Chordata;Actinopterygii;Cypriniformes;Cyprinidae;Cyprinella;spiloptera;
DQ536422_Cyprinella_spiloptera	Animalia;Chordata;Actinopterygii;Cypriniformes;Cyprinidae;Cyprinella;spiloptera;
FJ655278_Cyprinus_carpio	Animalia;Chordata;Actinopterygii;Cypriniformes;Cyprinidae;Cyprinus;carpio;
KU159761_Cyprinus_carpio	Animalia;Chordata;Actinopterygii;Cypriniformes;Cyprinidae;Cyprinus;carpio;
FJ655273_Cyprinus_carpio	Animalia;Chordata;Actinopterygii;Cypriniformes;Cyprinidae;Cyprinus;carpio;
AP017363_Cyprinus_carpio	Animalia;Chordata;Actinopterygii;Cypriniformes;Cyprinidae;Cyprinus;carpio;
JN105354_Cyprinus_carpio	Animalia;Chordata;Actinopterygii;Cypriniformes;Cyprinidae;Cyprinus;carpio;
FJ655271_Cyprinus_carpio	Animalia;Chordata;Actinopterygii;Cypriniformes;Cyprinidae;Cyprinus;carpio;
KR476848_Cyprinus_carpio	Animalia;Chordata;Actinopterygii;Cypriniformes;Cyprinidae;Cyprinus;carpio;
FJ655272_Cyprinus_carpio	Animalia;Chordata;Actinopterygii;Cypriniformes;Cyprinidae;Cyprinus;carpio;
EU811071_Hybognathus_hankinsoni	Animalia;Chordata;Actinopterygii;Cypriniformes;Cyprinidae;Hybognathus;hankinsoni;
EU811068_Hybognathus_hankinsoni	Animalia;Chordata;Actinopterygii;Cypriniformes;Cyprinidae;Hybognathus;hankinsoni;
EU811067_Hybognathus_hankinsoni	Animalia;Chordata;Actinopterygii;Cypriniformes;Cyprinidae;Hybognathus;hankinsoni;
MG570449_Luxilus_cornutus	Animalia;Chordata;Actinopterygii;Cypriniformes;Cyprinidae;Luxilus;cornutus;
U09471_Luxilus_cornutus	Animalia;Chordata;Actinopterygii;Cypriniformes;Cyprinidae;Luxilus;cornutus;
U09470_Luxilus_cornutus	Animalia;Chordata;Actinopterygii;Cypriniformes;Cyprinidae;Luxilus;cornutus;
AP012090_Luxilus_cornutus	Animalia;Chordata;Actinopterygii;Cypriniformes;Cyprinidae;Luxilus;cornutus;
AP012079_Luxilus_chrysocephalus	Animalia;Chordata;Actinopterygii;Cypriniformes;Cyprinidae;Luxilus;chrysocephalus;
U09472_Luxilus_chrysocephalus	Animalia;Chordata;Actinopterygii;Cypriniformes;Cyprinidae;Luxilus;chrysocephalus;
U09474_Luxilus_chrysocephalus	Animalia;Chordata;Actinopterygii;Cypriniformes;Cyprinidae;Luxilus;chrysocephalus;
U09473_Luxilus_chrysocephalus	Animalia;Chordata;Actinopterygii;Cypriniformes;Cyprinidae;Luxilus;chrysocephalus;
U09469_Luxilus_chrysocephalus	Animalia;Chordata;Actinopterygii;Cypriniformes;Cyprinidae;Luxilus;chrysocephalus;
AP012094_Lythrurus_umbratilis	Animalia;Chordata;Actinopterygii;Cypriniformes;Cyprinidae;Lythrurus;umbratilis;
AY216542_Lythrurus_umbratilis	Animalia;Chordata;Actinopterygii;Cypriniformes;Cyprinidae;Lythrurus;umbratilis;
GU134275_Macrhybopsis_aestivalis	Animalia;Chordata;Actinopterygii;Cypriniformes;Cyprinidae;Macrhybopsis;aestivalis;
KX139438_Macrhybopsis_storeriana	Animalia;Chordata;Actinopterygii;Cypriniformes;Cyprinidae;Macrhybopsis;storeriana;
AF081852_Macrhybopsis_storeriana	Animalia;Chordata;Actinopterygii;Cypriniformes;Cyprinidae;Macrhybopsis;storeriana;
AP012081_Margariscus_margarita	Animalia;Chordata;Actinopterygii;Cypriniformes;Cyprinidae;Margariscus;margarita;
AF081854_Nocomis_biguttatus	Animalia;Chordata;Actinopterygii;Cypriniformes;Cyprinidae;Nocomis;biguttatus;
MH324421_Nocomis_micropogon	Animalia;Chordata;Actinopterygii;Cypriniformes;Cyprinidae;Nocomis;micropogon;
KP013116_Notemigonus_crysoleucas	Animalia;Chordata;Actinopterygii;Cypriniformes;Cyprinidae;Notemigonus;crysoleucas;
AB127393_Notemigonus_crysoleucas	Animalia;Chordata;Actinopterygii;Cypriniformes;Cyprinidae;Notemigonus;crysoleucas;
AY216543_Notemigonus_crysoleucas	Animalia;Chordata;Actinopterygii;Cypriniformes;Cyprinidae;Notemigonus;crysoleucas;
AF038486_Notropis_atherinoides	Animalia;Chordata;Actinopterygii;Cypriniformes;Cyprinidae;Notropis;atherinoides;
NAT00037_Notropis_atherinoides	Animalia;Chordata;Actinopterygii;Cypriniformes;Cyprinidae;Notropis;atherinoides;
AY216534_Notropis_buccatus	Animalia;Chordata;Actinopterygii;Cypriniformes;Cyprinidae;Notropis;buccatus;
AF148350_Notropis_dorsalis	Animalia;Chordata;Actinopterygii;Cypriniformes;Cyprinidae;Notropis;dorsalis;
NHE00032_Notropis_heterodon	Animalia;Chordata;Actinopterygii;Cypriniformes;Cyprinidae;Notropis;heterodon;
MG570414_Notropis_heterolepis	Animalia;Chordata;Actinopterygii;Cypriniformes;Cyprinidae;Notropis;heterolepis;
U09475_Notropis_rubellus	Animalia;Chordata;Actinopterygii;Cypriniformes;Cyprinidae;Notropis;rubellus;
NHU00035_Notropis_hudsonius	Animalia;Chordata;Actinopterygii;Cypriniformes;Cyprinidae;Notropis;hudsonius;
NST00030_Notropis_stramineus	Animalia;Chordata;Actinopterygii;Cypriniformes;Cyprinidae;Notropis;stramineus;
NST00031_Notropis_stramineus	Animalia;Chordata;Actinopterygii;Cypriniformes;Cyprinidae;Notropis;stramineus;
DQ536429_Notropis_stramineus	Animalia;Chordata;Actinopterygii;Cypriniformes;Cyprinidae;Notropis;stramineus;
AY216553_Notropis_volucellus	Animalia;Chordata;Actinopterygii;Cypriniformes;Cyprinidae;Notropis;volucellus;
NVO00034_Notropis_volucellus	Animalia;Chordata;Actinopterygii;Cypriniformes;Cyprinidae;Notropis;volucellus;
AP012085_Opsopoeodus_emiliae	Animalia;Chordata;Actinopterygii;Cypriniformes;Cyprinidae;Opsopoeodus;emiliae;
DQ536431_Phenacobius_mirabilis	Animalia;Chordata;Actinopterygii;Cypriniformes;Cyprinidae;Phenacobius;mirabilis;
KT278765_Pimephales_promelas	Animalia;Chordata;Actinopterygii;Cypriniformes;Cyprinidae;Pimephales;promelas;
KT289925_Pimephales_promelas	Animalia;Chordata;Actinopterygii;Cypriniformes;Cyprinidae;Pimephales;promelas;
MG570454_Pimephales_promelas	Animalia;Chordata;Actinopterygii;Cypriniformes;Cyprinidae;Pimephales;promelas;
AP012101_Pimephales_notatus	Animalia;Chordata;Actinopterygii;Cypriniformes;Cyprinidae;Pimephales;notatus;
AY216556_Pimephales_notatus	Animalia;Chordata;Actinopterygii;Cypriniformes;Cyprinidae;Pimephales;notatus;
AP009151_Phoxinus_eos	Animalia;Chordata;Actinopterygii;Cypriniformes;Cyprinidae;Phoxinus;eos;
AP011276_Phoxinus_erythrogaster	Animalia;Chordata;Actinopterygii;Cypriniformes;Cyprinidae;Phoxinus;erythrogaster;
AF038493_Phoxinus_neogaeus	Animalia;Chordata;Actinopterygii;Cypriniformes;Cyprinidae;Phoxinus;neogaeus;
AF023199_Semotilus_atromaculatus	Animalia;Chordata;Actinopterygii;Cypriniformes;Cyprinidae;Semotilus;atromaculatus;
MG570417_Rhinichthys_obtusus	Animalia;Chordata;Actinopterygii;Cypriniformes;Cyprinidae;Rhinichthys;obtusus;
AP012105_Rhinichthys_cataractae	Animalia;Chordata;Actinopterygii;Cypriniformes;Cyprinidae;Rhinichthys;cataractae;
MG570446_Rhinichthys_cataractae	Animalia;Chordata;Actinopterygii;Cypriniformes;Cyprinidae;Rhinichthys;cataractae;
EU811082_Rhinichthys_cataractae	Animalia;Chordata;Actinopterygii;Cypriniformes;Cyprinidae;Rhinichthys;cataractae;
KR476929_Ctenopharyngodon_idella	Animalia;Chordata;Actinopterygii;Cypriniformes;Cyprinidae;Ctenopharyngodon;idella;
GQ406277_Ctenopharyngodon_idella	Animalia;Chordata;Actinopterygii;Cypriniformes;Cyprinidae;Ctenopharyngodon;idella;
GQ406281_Hypophthalmichthys_nobilis	Animalia;Chordata;Actinopterygii;Cypriniformes;Cyprinidae;Hypophthalmichthys;nobilis;
EU315941_Hypophthalmichthys_molitrix	Animalia;Chordata;Actinopterygii;Cypriniformes;Cyprinidae;Hypophthalmichthys;molitrix;
MF180230_Hypophthalmichthys_molitrix	Animalia;Chordata;Actinopterygii;Cypriniformes;Cyprinidae;Hypophthalmichthys;molitrix;
GQ406278_Mylopharyngodon_piceus	Animalia;Chordata;Actinopterygii;Cypriniformes;Cyprinidae;Mylopharyngodon;piceus;
MF687137_Mylopharyngodon_piceus	Animalia;Chordata;Actinopterygii;Cypriniformes;Cyprinidae;Mylopharyngodon;piceus;
DQ464905_Mylopharyngodon_piceus	Animalia;Chordata;Actinopterygii;Cypriniformes;Cyprinidae;Mylopharyngodon;piceus;
AF038491_Platygobio_gracilis	Animalia;Chordata;Actinopterygii;Cypriniformes;Cyprinidae;Platygobio;gracilis;
KR476958_Pseudorasbora_parva	Animalia;Chordata;Actinopterygii;Cypriniformes;Cyprinidae;Pseudorasbora;parva;
LC098032_Pseudorasbora_parva	Animalia;Chordata;Actinopterygii;Cypriniformes;Cyprinidae;Pseudorasbora;parva;
GQ406307_Pseudorasbora_parva	Animalia;Chordata;Actinopterygii;Cypriniformes;Cyprinidae;Pseudorasbora;parva;
KU238078_Pseudorasbora_parva	Animalia;Chordata;Actinopterygii;Cypriniformes;Cyprinidae;Pseudorasbora;parva;
LC098029_Pseudorasbora_parva	Animalia;Chordata;Actinopterygii;Cypriniformes;Cyprinidae;Pseudorasbora;parva;
AY216537_Hybopsis_amblops	Animalia;Chordata;Actinopterygii;Cypriniformes;Cyprinidae;Hybopsis;amblops;
AF148354_Hybopsis_amblops	Animalia;Chordata;Actinopterygii;Cypriniformes;Cyprinidae;Hybopsis;amblops;
KR476897_Scardinius_erythrophthalmus	Animalia;Chordata;Actinopterygii;Cypriniformes;Cyprinidae;Scardinius;erythrophthalmus;
AF215479_Scardinius_erythrophthalmus	Animalia;Chordata;Actinopterygii;Cypriniformes;Cyprinidae;Scardinius;erythrophthalmus;
KR476978_Scardinius_erythrophthalmus	Animalia;Chordata;Actinopterygii;Cypriniformes;Cyprinidae;Scardinius;erythrophthalmus;
KM052222_Rhodeus_sericeus	Animalia;Chordata;Actinopterygii;Cypriniformes;Cyprinidae;Rhodeus;sericeus;
KR476946_Leuciscus_idus	Animalia;Chordata;Actinopterygii;Cypriniformes;Cyprinidae;Leuciscus;idus;
KF913024_Leuciscus_idus	Animalia;Chordata;Actinopterygii;Cypriniformes;Cyprinidae;Leuciscus;idus;
AB218686_Tinca_tinca	Animalia;Chordata;Actinopterygii;Cypriniformes;Cyprinidae;Tinca;tinca;
JF812096_Tinca_tinca	Animalia;Chordata;Actinopterygii;Cypriniformes;Cyprinidae;Tinca;tinca;
KF732666_Misgurnus_anguillicaudatus	Animalia;Chordata;Actinopterygii;Cypriniformes;Cobitidae;Misgurnus;anguillicaudatus;
DQ026434_Misgurnus_anguillicaudatus	Animalia;Chordata;Actinopterygii;Cypriniformes;Cobitidae;Misgurnus;anguillicaudatus;
KM186181_Misgurnus_anguillicaudatus	Animalia;Chordata;Actinopterygii;Cypriniformes;Cobitidae;Misgurnus;anguillicaudatus;
MF579257_Misgurnus_anguillicaudatus	Animalia;Chordata;Actinopterygii;Cypriniformes;Cobitidae;Misgurnus;anguillicaudatus;
KC509901_Misgurnus_anguillicaudatus	Animalia;Chordata;Actinopterygii;Cypriniformes;Cobitidae;Misgurnus;anguillicaudatus;
KC762740_Misgurnus_anguillicaudatus	Animalia;Chordata;Actinopterygii;Cypriniformes;Cobitidae;Misgurnus;anguillicaudatus;
HM856629_Misgurnus_anguillicaudatus	Animalia;Chordata;Actinopterygii;Cypriniformes;Cobitidae;Misgurnus;anguillicaudatus;
AP011291_Misgurnus_anguillicaudatus	Animalia;Chordata;Actinopterygii;Cypriniformes;Cobitidae;Misgurnus;anguillicaudatus;
MT471403_Carpiodes_cyprinus	Animalia;Chordata;Actinopterygii;Cypriniformes;Catostomidae;Carpiodes;cyprinus;
AF333595_Catostomus_catostomus	Animalia;Chordata;Actinopterygii;Cypriniformes;Catostomidae;Catostomus;catostomus;
NC008647_Catostomus_commersonii	Animalia;Chordata;Actinopterygii;Cypriniformes;Catostomidae;Catostomus;commersonii;
ESU00045_Erimyzon_sucetta	Animalia;Chordata;Actinopterygii;Cypriniformes;Catostomidae;Erimyzon;sucetta;
ESU00046_Erimyzon_sucetta	Animalia;Chordata;Actinopterygii;Cypriniformes;Catostomidae;Erimyzon;sucetta;
AB242169_Hypentelium_nigricans	Animalia;Chordata;Actinopterygii;Cypriniformes;Catostomidae;Hypentelium;nigricans;
KP306894_Ictiobus_cyprinellus	Animalia;Chordata;Actinopterygii;Cypriniformes;Catostomidae;Ictiobus;cyprinellus;
MG570436_Minytrema_melanops	Animalia;Chordata;Actinopterygii;Cypriniformes;Catostomidae;Minytrema;melanops;
DQ536432_Minytrema_melanops	Animalia;Chordata;Actinopterygii;Cypriniformes;Catostomidae;Minytrema;melanops;
AF333600_Moxostoma_anisurum	Animalia;Chordata;Actinopterygii;Cypriniformes;Catostomidae;Moxostoma;anisurum;
MAN00048_Moxostoma_anisurum	Animalia;Chordata;Actinopterygii;Cypriniformes;Catostomidae;Moxostoma;anisurum;
AF333601_Moxostoma_carinatum	Animalia;Chordata;Actinopterygii;Cypriniformes;Catostomidae;Moxostoma;carinatum;
MCA00053_Moxostoma_carinatum	Animalia;Chordata;Actinopterygii;Cypriniformes;Catostomidae;Moxostoma;carinatum;
MER00049_Moxostoma_erythrurum	Animalia;Chordata;Actinopterygii;Cypriniformes;Catostomidae;Moxostoma;erythrurum;
MMA00054_Moxostoma_macrolepidotum	Animalia;Chordata;Actinopterygii;Cypriniformes;Catostomidae;Moxostoma;macrolepidotum;
MVA00050_Moxostoma_valenciennesi	Animalia;Chordata;Actinopterygii;Cypriniformes;Catostomidae;Moxostoma;valenciennesi;
MVA00051_Moxostoma_valenciennesi	Animalia;Chordata;Actinopterygii;Cypriniformes;Catostomidae;Moxostoma;valenciennesi;
KT804702_Ameiurus_melas	Animalia;Chordata;Actinopterygii;Siluriformes;Ictaluridae;Ameiurus;melas;
DQ421876_Ameiurus_melas	Animalia;Chordata;Actinopterygii;Siluriformes;Ictaluridae;Ameiurus;melas;
DQ421878_Ameiurus_natalis	Animalia;Chordata;Actinopterygii;Siluriformes;Ictaluridae;Ameiurus;natalis;
AY458872_Ameiurus_natalis	Animalia;Chordata;Actinopterygii;Siluriformes;Ictaluridae;Ameiurus;natalis;
DQ421883_Ameiurus_natalis	Animalia;Chordata;Actinopterygii;Siluriformes;Ictaluridae;Ameiurus;natalis;
DQ421884_Ameiurus_natalis	Animalia;Chordata;Actinopterygii;Siluriformes;Ictaluridae;Ameiurus;natalis;
MF621734_Ameiurus_nebulosus	Animalia;Chordata;Actinopterygii;Siluriformes;Ictaluridae;Ameiurus;nebulosus;
KR476911_Ameiurus_nebulosus	Animalia;Chordata;Actinopterygii;Siluriformes;Ictaluridae;Ameiurus;nebulosus;
AF482987_Ictalurus_punctatus	Animalia;Chordata;Actinopterygii;Siluriformes;Ictaluridae;Ictalurus;punctatus;
AY458876_Noturus_flavus	Animalia;Chordata;Actinopterygii;Siluriformes;Ictaluridae;Noturus;flavus;
AY458874_Noturus_gyrinus	Animalia;Chordata;Actinopterygii;Siluriformes;Ictaluridae;Noturus;gyrinus;
AF118705_Noturus_gyrinus	Animalia;Chordata;Actinopterygii;Siluriformes;Ictaluridae;Noturus;gyrinus;
AY458875_Noturus_insignis	Animalia;Chordata;Actinopterygii;Siluriformes;Ictaluridae;Noturus;insignis;
AF118694_Noturus_insignis	Animalia;Chordata;Actinopterygii;Siluriformes;Ictaluridae;Noturus;insignis;
MF621727_Pylodictis_olivaris	Animalia;Chordata;Actinopterygii;Siluriformes;Ictaluridae;Pylodictis;olivaris;
AF118693_Pylodictis_olivaris	Animalia;Chordata;Actinopterygii;Siluriformes;Ictaluridae;Pylodictis;olivaris;
KR476979_Silurus_glanis	Animalia;Chordata;Actinopterygii;Siluriformes;Siluridae;Silurus;glanis;
AY443574_Esox_americanus	Animalia;Chordata;Actinopterygii;Esociformes;Esocidae;Esox;americanus;
EAM00070_Esox_americanus	Animalia;Chordata;Actinopterygii;Esociformes;Esocidae;Esox;americanus;
AF060446_Esox_lucius	Animalia;Chordata;Actinopterygii;Esociformes;Esocidae;Esox;lucius;
AP004103_Esox_lucius	Animalia;Chordata;Actinopterygii;Esociformes;Esocidae;Esox;lucius;
KT124235_Esox_lucius	Animalia;Chordata;Actinopterygii;Esociformes;Esocidae;Esox;lucius;
AF262314_Esox_lucius	Animalia;Chordata;Actinopterygii;Esociformes;Esocidae;Esox;lucius;
AF262311_Esox_lucius	Animalia;Chordata;Actinopterygii;Esociformes;Esocidae;Esox;lucius;
AF262310_Esox_lucius	Animalia;Chordata;Actinopterygii;Esociformes;Esocidae;Esox;lucius;
AP013046_Esox_niger	Animalia;Chordata;Actinopterygii;Esociformes;Esocidae;Esox;niger;
AF262308_Esox_masquinongy	Animalia;Chordata;Actinopterygii;Esociformes;Esocidae;Esox;masquinongy;
AY443571_Esox_masquinongy	Animalia;Chordata;Actinopterygii;Esociformes;Esocidae;Esox;masquinongy;
KM435059_Umbra_limi	Animalia;Chordata;Actinopterygii;Esociformes;Umbridae;Umbra;limi;
HM106493_Osmerus_mordax	Animalia;Chordata;Actinopterygii;Osmeriformes;Osmeridae;Osmerus;mordax;
MF621765_Coregonus_artedi	Animalia;Chordata;Actinopterygii;Salmoniformes;Salmonidae;Coregonus;artedi;
JQ390060_Coregonus_clupeaformis	Animalia;Chordata;Actinopterygii;Salmoniformes;Salmonidae;Coregonus;clupeaformis;
EF455489_Oncorhynchus_gorbuscha	Animalia;Chordata;Actinopterygii;Salmoniformes;Salmonidae;Oncorhynchus;gorbuscha;
MF621749_Oncorhynchus_kisutch	Animalia;Chordata;Actinopterygii;Salmoniformes;Salmonidae;Oncorhynchus;kisutch;
KU170134_Oncorhynchus_kisutch	Animalia;Chordata;Actinopterygii;Salmoniformes;Salmonidae;Oncorhynchus;kisutch;
KU170133_Oncorhynchus_kisutch	Animalia;Chordata;Actinopterygii;Salmoniformes;Salmonidae;Oncorhynchus;kisutch;
AY236431_Oncorhynchus_mykiss	Animalia;Chordata;Actinopterygii;Salmoniformes;Salmonidae;Oncorhynchus;mykiss;
EU338376_Oncorhynchus_mykiss	Animalia;Chordata;Actinopterygii;Salmoniformes;Salmonidae;Oncorhynchus;mykiss;
AF392054_Oncorhynchus_tshawytscha	Animalia;Chordata;Actinopterygii;Salmoniformes;Salmonidae;Oncorhynchus;tshawytscha;
KU170130_Oncorhynchus_tshawytscha	Animalia;Chordata;Actinopterygii;Salmoniformes;Salmonidae;Oncorhynchus;tshawytscha;
KU170129_Oncorhynchus_tshawytscha	Animalia;Chordata;Actinopterygii;Salmoniformes;Salmonidae;Oncorhynchus;tshawytscha;
KU170128_Oncorhynchus_tshawytscha	Animalia;Chordata;Actinopterygii;Salmoniformes;Salmonidae;Oncorhynchus;tshawytscha;
EF055889_Oncorhynchus_nerka	Animalia;Chordata;Actinopterygii;Salmoniformes;Salmonidae;Oncorhynchus;nerka;
KU170135_Oncorhynchus_nerka	Animalia;Chordata;Actinopterygii;Salmoniformes;Salmonidae;Oncorhynchus;nerka;
AY800002_Oncorhynchus_nerka	Animalia;Chordata;Actinopterygii;Salmoniformes;Salmonidae;Oncorhynchus;nerka;
L29771_Oncorhynchus_mykiss	Animalia;Chordata;Actinopterygii;Salmoniformes;Salmonidae;Oncorhynchus;mykiss;
AF125508_Oncorhynchus_mykiss	Animalia;Chordata;Actinopterygii;Salmoniformes;Salmonidae;Oncorhynchus;mykiss;
KU170140_Oncorhynchus_mykiss	Animalia;Chordata;Actinopterygii;Salmoniformes;Salmonidae;Oncorhynchus;mykiss;
MT581651_Prosopium_coulterii	Animalia;Chordata;Actinopterygii;Salmoniformes;Salmonidae;Prosopium;coulterii;
MT581650_Prosopium_coulterii	Animalia;Chordata;Actinopterygii;Salmoniformes;Salmonidae;Prosopium;coulterii;
MT581649_Prosopium_coulterii	Animalia;Chordata;Actinopterygii;Salmoniformes;Salmonidae;Prosopium;coulterii;
MF621767_Prosopium_cylindraceum	Animalia;Chordata;Actinopterygii;Salmoniformes;Salmonidae;Prosopium;cylindraceum;
AF133701_Salmo_salar	Animalia;Chordata;Actinopterygii;Salmoniformes;Salmonidae;Salmo;salar;
AF446387_Salmo_trutta	Animalia;Chordata;Actinopterygii;Salmoniformes;Salmonidae;Salmo;trutta;
JQ390057_Salmo_trutta	Animalia;Chordata;Actinopterygii;Salmoniformes;Salmonidae;Salmo;trutta;
AF446375_Salmo_trutta	Animalia;Chordata;Actinopterygii;Salmoniformes;Salmonidae;Salmo;trutta;
LC137015_Salmo_trutta	Animalia;Chordata;Actinopterygii;Salmoniformes;Salmonidae;Salmo;trutta;
AF446391_Salmo_trutta	Animalia;Chordata;Actinopterygii;Salmoniformes;Salmonidae;Salmo;trutta;
AF446382_Salmo_trutta	Animalia;Chordata;Actinopterygii;Salmoniformes;Salmonidae;Salmo;trutta;
AF154850_Salvelinus_fontinalis	Animalia;Chordata;Actinopterygii;Salmoniformes;Salmonidae;Salvelinus;fontinalis;
AB898751_Salvelinus_namaycush	Animalia;Chordata;Actinopterygii;Salmoniformes;Salmonidae;Salvelinus;namaycush;
AF049741_Percopsis_omiscomaycus	Animalia;Chordata;Actinopterygii;Percopsiformes;Percopsidae;Percopsis;omiscomaycus;
KC441996_Percopsis_omiscomaycus	Animalia;Chordata;Actinopterygii;Percopsiformes;Percopsidae;Percopsis;omiscomaycus;
AP004403_Aphredoderus_sayanus	Animalia;Chordata;Actinopterygii;Percopsiformes;Aphredoderidae;Aphredoderus;sayanus;
DQ077960_Lota_lota	Animalia;Chordata;Actinopterygii;Gadiformes;Lotidae;Lota;lota;
KC844053_Lota_lota	Animalia;Chordata;Actinopterygii;Gadiformes;Lotidae;Lota;lota;
KP013106_Fundulus_notatus	Animalia;Chordata;Actinopterygii;Cyprinodontiformes;Fundulidae;Fundulus;notatus;
FJ445395_Fundulus_diaphanus	Animalia;Chordata;Actinopterygii;Cyprinodontiformes;Fundulidae;Fundulus;diaphanus;
FDI00088_Fundulus_diaphanus	Animalia;Chordata;Actinopterygii;Cyprinodontiformes;Fundulidae;Fundulus;diaphanus;
AY655496_Labidesthes_sicculus	Animalia;Chordata;Actinopterygii;Atheriniformes;Atherinopsidae;Labidesthes;sicculus;
AB445125_Culaea_inconstans	Animalia;Chordata;Actinopterygii;Gasterosteiformes;Gasterosteidae;Culaea;inconstans;
AY283366_Culaea_inconstans	Animalia;Chordata;Actinopterygii;Gasterosteiformes;Gasterosteidae;Culaea;inconstans;
AY283364_Culaea_inconstans	Animalia;Chordata;Actinopterygii;Gasterosteiformes;Gasterosteidae;Culaea;inconstans;
AY283365_Culaea_inconstans	Animalia;Chordata;Actinopterygii;Gasterosteiformes;Gasterosteidae;Culaea;inconstans;
AY283363_Culaea_inconstans	Animalia;Chordata;Actinopterygii;Gasterosteiformes;Gasterosteidae;Culaea;inconstans;
AP002944_Gasterosteus_aculeatus	Animalia;Chordata;Actinopterygii;Gasterosteiformes;Gasterosteidae;Gasterosteus;aculeatus;
AY283359_Gasterosteus_aculeatus	Animalia;Chordata;Actinopterygii;Gasterosteiformes;Gasterosteidae;Gasterosteus;aculeatus;
AB445126_Apeltes_quadracus	Animalia;Chordata;Actinopterygii;Gasterosteiformes;Gasterosteidae;Apeltes;quadracus;
AY538971_Apeltes_quadracus	Animalia;Chordata;Actinopterygii;Gasterosteiformes;Gasterosteidae;Apeltes;quadracus;
AY283356_Apeltes_quadracus	Animalia;Chordata;Actinopterygii;Gasterosteiformes;Gasterosteidae;Apeltes;quadracus;
KT989571_Pungitius_pungitius	Animalia;Chordata;Actinopterygii;Gasterosteiformes;Gasterosteidae;Pungitius;pungitius;
AB445130_Pungitius_pungitius	Animalia;Chordata;Actinopterygii;Gasterosteiformes;Gasterosteidae;Pungitius;pungitius;
KJ627964_Pungitius_pungitius	Animalia;Chordata;Actinopterygii;Gasterosteiformes;Gasterosteidae;Pungitius;pungitius;
KJ627956_Pungitius_pungitius	Animalia;Chordata;Actinopterygii;Gasterosteiformes;Gasterosteidae;Pungitius;pungitius;
AY283362_Pungitius_pungitius	Animalia;Chordata;Actinopterygii;Gasterosteiformes;Gasterosteidae;Pungitius;pungitius;
KJ627945_Pungitius_pungitius	Animalia;Chordata;Actinopterygii;Gasterosteiformes;Gasterosteidae;Pungitius;pungitius;
KJ627942_Pungitius_pungitius	Animalia;Chordata;Actinopterygii;Gasterosteiformes;Gasterosteidae;Pungitius;pungitius;
KJ627940_Pungitius_pungitius	Animalia;Chordata;Actinopterygii;Gasterosteiformes;Gasterosteidae;Pungitius;pungitius;
KJ627939_Pungitius_pungitius	Animalia;Chordata;Actinopterygii;Gasterosteiformes;Gasterosteidae;Pungitius;pungitius;
KJ627938_Pungitius_pungitius	Animalia;Chordata;Actinopterygii;Gasterosteiformes;Gasterosteidae;Pungitius;pungitius;
KJ627943_Pungitius_pungitius	Animalia;Chordata;Actinopterygii;Gasterosteiformes;Gasterosteidae;Pungitius;pungitius;
KP013090_Cottus_bairdii	Animalia;Chordata;Actinopterygii;Scorpaeniformes;Cottidae;Cottus;bairdii;
KJ778623_Cottus_cognatus	Animalia;Chordata;Actinopterygii;Scorpaeniformes;Cottidae;Cottus;cognatus;
MT539215_Cottus_ricei	Animalia;Chordata;Actinopterygii;Scorpaeniformes;Cottidae;Cottus;ricei;
MT581585_Cottus_ricei	Animalia;Chordata;Actinopterygii;Scorpaeniformes;Cottidae;Cottus;ricei;
HQ731434_Morone_chrysops	Animalia;Chordata;Actinopterygii;Perciformes;Moronidae;Morone;chrysops;
KU641485_Morone_americana	Animalia;Chordata;Actinopterygii;Perciformes;Moronidae;Morone;americana;
AY742515_Ambloplites_rupestris	Animalia;Chordata;Actinopterygii;Perciformes;Centrarchidae;Ambloplites;rupestris;
KP013087_Lepomis_cyanellus	Animalia;Chordata;Actinopterygii;Perciformes;Centrarchidae;Lepomis;cyanellus;
KP013097_Lepomis_gibbosus	Animalia;Chordata;Actinopterygii;Perciformes;Centrarchidae;Lepomis;gibbosus;
KR476944_Lepomis_gibbosus	Animalia;Chordata;Actinopterygii;Perciformes;Centrarchidae;Lepomis;gibbosus;
AY742526_Lepomis_gulosus	Animalia;Chordata;Actinopterygii;Perciformes;Centrarchidae;Lepomis;gulosus;
AY742528_Lepomis_humilis	Animalia;Chordata;Actinopterygii;Perciformes;Centrarchidae;Lepomis;humilis;
AP005993_Lepomis_macrochirus	Animalia;Chordata;Actinopterygii;Perciformes;Centrarchidae;Lepomis;macrochirus;
JX567607_Lepomis_macrochirus	Animalia;Chordata;Actinopterygii;Perciformes;Centrarchidae;Lepomis;macrochirus;
JX567605_Lepomis_macrochirus	Animalia;Chordata;Actinopterygii;Perciformes;Centrarchidae;Lepomis;macrochirus;
JX567603_Lepomis_macrochirus	Animalia;Chordata;Actinopterygii;Perciformes;Centrarchidae;Lepomis;macrochirus;
AY742535_Lepomis_microlophus	Animalia;Chordata;Actinopterygii;Perciformes;Centrarchidae;Lepomis;microlophus;
AY742532_Lepomis_megalotis	Animalia;Chordata;Actinopterygii;Perciformes;Centrarchidae;Lepomis;megalotis;
AY742533_Lepomis_megalotis	Animalia;Chordata;Actinopterygii;Perciformes;Centrarchidae;Lepomis;megalotis;
AB378750_Micropterus_dolomieu	Animalia;Chordata;Actinopterygii;Perciformes;Centrarchidae;Micropterus;dolomieu;
DQ536425_Micropterus_salmoides	Animalia;Chordata;Actinopterygii;Perciformes;Centrarchidae;Micropterus;salmoides;
KP013112_Pomoxis_nigromaculatus	Animalia;Chordata;Actinopterygii;Perciformes;Centrarchidae;Pomoxis;nigromaculatus;
AY742554_Pomoxis_annularis	Animalia;Chordata;Actinopterygii;Perciformes;Centrarchidae;Pomoxis;annularis;
AY742519_Enneacanthus_gloriosus	Animalia;Chordata;Actinopterygii;Perciformes;Centrarchidae;Enneacanthus;gloriosus;
AY539054_Etheostoma_blennioides	Animalia;Chordata;Actinopterygii;Perciformes;Percidae;Etheostoma;blennioides;
KY660678_Etheostoma_caeruleum	Animalia;Chordata;Actinopterygii;Perciformes;Percidae;Etheostoma;caeruleum;
AP005994_Etheostoma_zonale	Animalia;Chordata;Actinopterygii;Perciformes;Percidae;Etheostoma;zonale;
EEX00115_Etheostoma_exile	Animalia;Chordata;Actinopterygii;Perciformes;Percidae;Etheostoma;exile;
MH301060_Etheostoma_flabellare	Animalia;Chordata;Actinopterygii;Perciformes;Percidae;Etheostoma;flabellare;
EF120839_Etheostoma_nigrum	Animalia;Chordata;Actinopterygii;Perciformes;Percidae;Etheostoma;nigrum;
KT289926_Etheostoma_nigrum	Animalia;Chordata;Actinopterygii;Perciformes;Percidae;Etheostoma;nigrum;
MK243404_Etheostoma_spectabile	Animalia;Chordata;Actinopterygii;Perciformes;Percidae;Etheostoma;spectabile;
KR476857_Gymnocephalus_cernua	Animalia;Chordata;Actinopterygii;Perciformes;Percidae;Gymnocephalus;cernua;
KR476939_Gymnocephalus_cernua	Animalia;Chordata;Actinopterygii;Perciformes;Percidae;Gymnocephalus;cernua;
KM978956_Gymnocephalus_cernua	Animalia;Chordata;Actinopterygii;Perciformes;Percidae;Gymnocephalus;cernua;
JX629446_Perca_flavescens	Animalia;Chordata;Actinopterygii;Perciformes;Percidae;Perca;flavescens;
PCA00119_Percina_caprodes	Animalia;Chordata;Actinopterygii;Perciformes;Percidae;Percina;caprodes;
EF120840_Percina_caprodes	Animalia;Chordata;Actinopterygii;Perciformes;Percidae;Percina;caprodes;
AY520098_Percina_maculata	Animalia;Chordata;Actinopterygii;Perciformes;Percidae;Percina;maculata;
PMA00122_Percina_maculata	Animalia;Chordata;Actinopterygii;Perciformes;Percidae;Percina;maculata;
KT211477_Sander_canadensis	Animalia;Chordata;Actinopterygii;Perciformes;Percidae;Sander;canadensis;
JX567620_Sander_canadensis	Animalia;Chordata;Actinopterygii;Perciformes;Percidae;Sander;canadensis;
KT211478_Sander_canadensis	Animalia;Chordata;Actinopterygii;Perciformes;Percidae;Sander;canadensis;
KR476977_Sander_lucioperca	Animalia;Chordata;Actinopterygii;Perciformes;Percidae;Sander;lucioperca;
KP013098_Sander_vitreus	Animalia;Chordata;Actinopterygii;Perciformes;Percidae;Sander;vitreus;
AY520093_Aplodinotus_grunniens	Animalia;Chordata;Actinopterygii;Perciformes;Sciaenidae;Aplodinotus;grunniens;
KJ128947_Zoarces_viviparus	Animalia;Chordata;Actinopterygii;Perciformes;Zoarcidae;Zoarces;viviparus;
KR476870_Neogobius_melanostomus	Animalia;Chordata;Actinopterygii;Gobiiformes;Gobiidae;Neogobius;melanostomus;
NME00126_Neogobius_melanostomus	Animalia;Chordata;Actinopterygii;Gobiiformes;Gobiidae;Neogobius;melanostomus;
KR476957_Proterorhinus_semilunaris	Animalia;Chordata;Actinopterygii;Gobiiformes;Gobiidae;Proterorhinus;semilunaris;
KF415448_Proterorhinus_marmoratus	Animalia;Chordata;Actinopterygii;Gobiiformes;Gobiidae;Proterorhinus;marmoratus;
AP004422_Gambusia_affinis	Animalia;Chordata;Actinopterygii;Cyprinodontiformes;Poeciliidae;Gambusia;affinis;
KC823605_Channa_argus	Animalia;Chordata;Actinopterygii;Anabantiformes;Channidae;Channa;argus;
JQ358712_Channa_argus	Animalia;Chordata;Actinopterygii;Anabantiformes;Channidae;Channa;argus;
GU937112_Channa_argus	Animalia;Chordata;Actinopterygii;Anabantiformes;Channidae;Channa;argus;
MG751766_Channa_argus	Animalia;Chordata;Actinopterygii;Anabantiformes;Channidae;Channa;argus;
MG546004_Homo_sapiens	Animalia;Chordata;Mammalia;Primates;Hominidae;Homo;sapiens;
MF114223_Homo_sapiens	Animalia;Chordata;Mammalia;Primates;Hominidae;Homo;sapiens;
MG548631_Homo_sapiens	Animalia;Chordata;Mammalia;Primates;Hominidae;Homo;sapiens;
DQ334848_Didelphis_virginiana	Animalia;Chordata;Mammalia;Didelphimorphia;Didelphidae;Didelphis;virginiana;
JN315625_Ondatra_zibethicus	Animalia;Chordata;Mammalia;Rodentia;Cricetidae;Ondatra;zibethicus;
KU177045_Ondatra_zibethicus	Animalia;Chordata;Mammalia;Rodentia;Cricetidae;Ondatra;zibethicus;
KY321562_Castor_canadensis	Animalia;Chordata;Mammalia;Rodentia;Castoridae;Castor;canadensis;
KY311838_Castor_canadensis	Animalia;Chordata;Mammalia;Rodentia;Castoridae;Castor;canadensis;
FR691684_Castor_canadensis	Animalia;Chordata;Mammalia;Rodentia;Castoridae;Castor;canadensis;
KM612279_Odocoileus_virginianus	Animalia;Chordata;Mammalia;Artiodactyla;Cervidae;Odocoileus;virginianus;
KM612274_Odocoileus_virginianus	Animalia;Chordata;Mammalia;Artiodactyla;Cervidae;Odocoileus;virginianus;
KM612272_Odocoileus_virginianus	Animalia;Chordata;Mammalia;Artiodactyla;Cervidae;Odocoileus;virginianus;
JN632671_Odocoileus_virginianus	Animalia;Chordata;Mammalia;Artiodactyla;Cervidae;Odocoileus;virginianus;
JN632673_Odocoileus_virginianus	Animalia;Chordata;Mammalia;Artiodactyla;Cervidae;Odocoileus;virginianus;
M35874_Odocoileus_virginianus	Animalia;Chordata;Mammalia;Artiodactyla;Cervidae;Odocoileus;virginianus;
KJ870164_Cervus_canadensis	Animalia;Chordata;Mammalia;Artiodactyla;Cervidae;Cervus;canadensis;
MG674648_Peromyscus_leucopus	Animalia;Chordata;Mammalia;Rodentia;Cricetidae;Peromyscus;leucopus;
NC037180_Peromyscus_leucopus	Animalia;Chordata;Mammalia;Rodentia;Cricetidae;Peromyscus;leucopus;
JN181159_Peromyscus_leucopus	Animalia;Chordata;Mammalia;Rodentia;Cricetidae;Peromyscus;leucopus;
HM106330_Taxidea_taxus	Animalia;Chordata;Mammalia;Carnivora;Mustelidae;Taxidea;taxus;
HM106324_Martes_americana	Animalia;Chordata;Mammalia;Carnivora;Mustelidae;Martes;americana;
HQ705179_Martes_pennanti	Animalia;Chordata;Mammalia;Carnivora;Mustelidae;Martes;pennanti;
KR611313_Gulo_gulo	Animalia;Chordata;Mammalia;Carnivora;Mustelidae;Gulo;gulo;
KP642032_Gulo_gulo	Animalia;Chordata;Mammalia;Carnivora;Mustelidae;Gulo;gulo;
KU146454_Neovison_vison	Animalia;Chordata;Mammalia;Carnivora;Mustelidae;Neovison;vison;
HM106322_Neovison_vison	Animalia;Chordata;Mammalia;Carnivora;Mustelidae;Neovison;vison;
DQ630360_Blarina_brevicauda	Animalia;Chordata;Mammalia;Eulipotyphla;Soricidae;Blarina;brevicauda;
KT876727_Blarina_brevicauda	Animalia;Chordata;Mammalia;Eulipotyphla;Soricidae;Blarina;brevicauda;
DQ630339_Blarina_brevicauda	Animalia;Chordata;Mammalia;Eulipotyphla;Soricidae;Blarina;brevicauda;
AF395462_Blarina_brevicauda	Animalia;Chordata;Mammalia;Eulipotyphla;Soricidae;Blarina;brevicauda;
AF395461_Blarina_brevicauda	Animalia;Chordata;Mammalia;Eulipotyphla;Soricidae;Blarina;brevicauda;
DQ630338_Sorex_cinereus	Animalia;Chordata;Mammalia;Eulipotyphla;Soricidae;Sorex;cinereus;
AF395486_Sorex_cinereus	Animalia;Chordata;Mammalia;Eulipotyphla;Soricidae;Sorex;cinereus;
U97343_Sorex_palustris	Animalia;Chordata;Mammalia;Eulipotyphla;Soricidae;Sorex;palustris;
AB297804_Procyon_lotor	Animalia;Chordata;Mammalia;Carnivora;Procyonidae;Procyon;lotor;
AB291073_Procyon_lotor	Animalia;Chordata;Mammalia;Carnivora;Procyonidae;Procyon;lotor;
AB462167_Procyon_lotor	Animalia;Chordata;Mammalia;Carnivora;Procyonidae;Procyon;lotor;
KT448277_Canis_latrans	Animalia;Chordata;Mammalia;Carnivora;Canidae;Canis;latrans;
KU696388_Canis_lupus	Animalia;Chordata;Mammalia;Carnivora;Canidae;Canis;lupus;
AB499816_Canis_familiaris	Animalia;Chordata;Mammalia;Carnivora;Canidae;Canis;familiaris;
JN711443_Vulpes_vulpes	Animalia;Chordata;Mammalia;Carnivora;Canidae;Vulpes;vulpes;
KT448287_Vulpes_vulpes	Animalia;Chordata;Mammalia;Carnivora;Canidae;Vulpes;vulpes;
GQ374180_Vulpes_vulpes	Animalia;Chordata;Mammalia;Carnivora;Canidae;Vulpes;vulpes;
AM181037_Vulpes_vulpes	Animalia;Chordata;Mammalia;Carnivora;Canidae;Vulpes;vulpes;
AF288629_Felis_catus	Animalia;Chordata;Mammalia;Carnivora;Felidae;Felis;catus;
KF908862_Felis_catus	Animalia;Chordata;Mammalia;Carnivora;Felidae;Felis;catus;
U20753_Felis_catus	Animalia;Chordata;Mammalia;Carnivora;Felidae;Felis;catus;
GQ979707_Lynx_rufus	Animalia;Chordata;Mammalia;Carnivora;Felidae;Lynx;rufus;
AY499294_Lynx_rufus	Animalia;Chordata;Mammalia;Carnivora;Felidae;Lynx;rufus;
KP202281_Lynx_canadensis	Animalia;Chordata;Mammalia;Carnivora;Felidae;Lynx;canadensis;
AY499297_Lynx_canadensis	Animalia;Chordata;Mammalia;Carnivora;Felidae;Lynx;canadensis;
MF143474_Eptesicus_fuscus	Animalia;Chordata;Mammalia;Chiroptera;Vespertilionidae;Eptesicus;fuscus;
AF303109_Ursus_americanus	Animalia;Chordata;Mammalia;Carnivora;Ursidae;Ursus;americanus;
KM257060_Ursus_americanus	Animalia;Chordata;Mammalia;Carnivora;Ursidae;Ursus;americanus;
KY070151_Tamias_striatus	Animalia;Chordata;Mammalia;Rodentia;Sciuridae;Tamias;striatus;
DQ334840_Sciurus_niger	Animalia;Chordata;Mammalia;Rodentia;Sciuridae;Sciurus;niger;
DQ334839_Sciurus_carolinensis	Animalia;Chordata;Mammalia;Rodentia;Sciuridae;Sciurus;carolinensis;
AF069539_Scalopus_aquaticus	Animalia;Chordata;Mammalia;Eulipotyphla;Talpidae;Scalopus;aquaticus;
KM091450_Mustela_erminea	Animalia;Chordata;Mammalia;Carnivora;Mustelidae;Mustela;erminea;
HM106321_Mustela_frenata	Animalia;Chordata;Mammalia;Carnivora;Mustelidae;Mustela;frenata;
DQ334836_Sylvilagus_floridanus	Animalia;Chordata;Mammalia;Lagomorpha;Leporidae;Sylvilagus;floridanus;
DQ334833_Lepus_americanus	Animalia;Chordata;Mammalia;Lagomorpha;Leporidae;Lepus;americanus;
KJ397613_Lepus_americanus	Animalia;Chordata;Mammalia;Lagomorpha;Leporidae;Lepus;americanus;
KU144678_Condylura_cristata	Animalia;Chordata;Mammalia;Eulipotyphla;Talpidae;Condylura;cristata;
KM114606_Rattus_norvegicus	Animalia;Chordata;Mammalia;Rodentia;Muridae;Rattus;norvegicus;
MF785090_Rattus_norvegicus	Animalia;Chordata;Mammalia;Rodentia;Muridae;Rattus;norvegicus;
HM106332_Mephitis_mephitis	Animalia;Chordata;Mammalia;Carnivora;Mephitidae;Mephitis;mephitis;
AY227473_Marmota_monax	Animalia;Chordata;Mammalia;Rodentia;Sciuridae;Marmota;monax;
NC024872_Turdus_migratorius	Animalia;Chordata;Aves;Passeriformes;Turdidae;Turdus;migratorius;
KM042922_Sturnus_vulgaris	Animalia;Chordata;Aves;Passeriformes;Sturnidae;Sturnus;vulgaris;
FJ465267_Sturnus_vulgaris	Animalia;Chordata;Aves;Passeriformes;Sturnidae;Sturnus;vulgaris;
JQ627250_Gallus_gallus	Animalia;Chordata;Aves;Galliformes;Phasianidae;Gallus;gallus;
DQ019124_Branta_canadensis	Animalia;Chordata;Aves;Anseriformes;Anatidae;Branta;canadensis;
EU009397_Anas_platyrhynchos	Animalia;Chordata;Aves;Anseriformes;Anatidae;Anas;platyrhynchos;
KJ637997_Anas_platyrhynchos	Animalia;Chordata;Aves;Anseriformes;Anatidae;Anas;platyrhynchos;
L22479_Anas_platyrhynchos	Animalia;Chordata;Aves;Anseriformes;Anatidae;Anas;platyrhynchos;
KX902235_Zenaida_macroura	Animalia;Chordata;Aves;Columbiformes;Columbidae;Zenaida;macroura;
EF153719_Meleagris_gallopavo	Animalia;Chordata;Aves;Galliformes;Phasianidae;Meleagris;gallopavo;
EF532935_Archilochus_colubris	Animalia;Chordata;Aves;Apodiformes;Trochilidae;Archilochus;colubris;
L33389_Podiceps_auritus	Animalia;Chordata;Aves;Podicipediformes;Podicipedidae;Podiceps;auritus;
KT809406_Chaetura_pelagica	Animalia;Chordata;Aves;Apodiformes;Apodidae;Chaetura;pelagica;
AF173582_Coccyzus_americanus	Animalia;Chordata;Aves;Cuculiformes;Cuculidae;Coccyzus;americanus;
DQ485863_Fulica_americana	Animalia;Chordata;Aves;Gruiformes;Rallidae;Fulica;americana;
FJ769855_Antigone_canadensis	Animalia;Chordata;Aves;Gruiformes;Gruidae;Antigone;canadensis;
AF173577_Gavia_immer	Animalia;Chordata;Aves;Gaviiformes;Gaviidae;Gavia;immer;
DQ485837_Botaurus_lentiginosus	Animalia;Chordata;Aves;Pelecaniformes;Ardeidae;Botaurus;lentiginosus;
KJ722534_Bubulcus_ibis	Animalia;Chordata;Aves;Pelecaniformes;Ardeidae;Bubulcus;ibis;
DQ485838_Bubulcus_ibis	Animalia;Chordata;Aves;Pelecaniformes;Ardeidae;Bubulcus;ibis;
AF373591_Phalacrocorax_auritus	Animalia;Chordata;Aves;Suliformes;Phalacrocoracidae;Phalacrocorax;auritus;
DQ385286_Charadrius_vociferus	Animalia;Chordata;Aves;Charadriiformes;Charadriidae;Charadrius;vociferus;
MF582632_Sterna_hirundo	Animalia;Chordata;Aves;Charadriiformes;Laridae;Sterna;hirundo;
MG916810_Asio_otus	Animalia;Chordata;Aves;Strigiformes;Strigidae;Asio;otus;
AY463690_Cathartes_aura	Animalia;Chordata;Aves;Accipitriformes;Cathartidae;Cathartes;aura;
DQ780884_Pandion_haliaetus	Animalia;Chordata;Aves;Accipitriformes;Pandionidae;Pandion;haliaetus;
GQ264618_Buteo_jamaicensis	Animalia;Chordata;Aves;Accipitriformes;Accipitridae;Buteo;jamaicensis;
KT119343_Picoides_pubescens	Animalia;Chordata;Aves;Piciformes;Picidae;Picoides;pubescens;
AF173562_Picoides_pubescens	Animalia;Chordata;Aves;Piciformes;Picidae;Picoides;pubescens;
DQ780880_Falco_sparverius	Animalia;Chordata;Aves;Falconiformes;Falconidae;Falco;sparverius;
KP403809_Corvus_brachyrhynchos	Animalia;Chordata;Aves;Passeriformes;Corvidae;Corvus;brachyrhynchos;
AF173600_Tyrannus_tyrannus	Animalia;Chordata;Aves;Passeriformes;Tyrannidae;Tyrannus;tyrannus;
KJ909193_Vireo_olivaceus	Animalia;Chordata;Aves;Passeriformes;Vireonidae;Vireo;olivaceus;
KJ909190_Poecile_atricapilla	Animalia;Chordata;Aves;Passeriformes;Paridae;Poecile;atricapilla;
KX398931_Hirundo_rustica	Animalia;Chordata;Aves;Passeriformes;Hirundinidae;Hirundo;rustica;
AF140873_Mimus_polyglottos	Animalia;Chordata;Aves;Passeriformes;Mimidae;Mimus;polyglottos;
KJ909195_Sitta_carolinensis	Animalia;Chordata;Aves;Passeriformes;Sittidae;Sitta;carolinensis;
KM042939_Sitta_carolinensis	Animalia;Chordata;Aves;Passeriformes;Sittidae;Sitta;carolinensis;
KM078782_Haemorhous_mexicanus	Animalia;Chordata;Aves;Passeriformes;Fringillidae;Haemorhous;mexicanus;
FJ236301_Spinus_tristis	Animalia;Chordata;Aves;Passeriformes;Fringillidae;Spinus;tristis;
AF202782_Junco_hyemalis	Animalia;Chordata;Aves;Passeriformes;Passerellidae;Junco;hyemalis;
FJ236289_Agelaius_phoeniceus	Animalia;Chordata;Aves;Passeriformes;Icteridae;Agelaius;phoeniceus;
KM078767_Agelaius_phoeniceus	Animalia;Chordata;Aves;Passeriformes;Icteridae;Agelaius;phoeniceus;
JX516064_Quiscalus_quiscula	Animalia;Chordata;Aves;Passeriformes;Icteridae;Quiscalus;quiscula;
KT345173_Geothlypis_trichas	Animalia;Chordata;Aves;Passeriformes;Parulidae;Geothlypis;trichas;
KM078795_Cardinalis_cardinalis	Animalia;Chordata;Aves;Passeriformes;Cardinalidae;Cardinalis;cardinalis;
AY283884_Cardinalis_cardinalis	Animalia;Chordata;Aves;Passeriformes;Cardinalidae;Cardinalis;cardinalis;
FJ236295_Cardinalis_cardinalis	Animalia;Chordata;Aves;Passeriformes;Cardinalidae;Cardinalis;cardinalis;
AY779237_Rana_blairi	Animalia;Chordata;Amphibia;Anura;Ranidae;Rana;blairi;
DQ283185_Rana_clamitans	Animalia;Chordata;Amphibia;Anura;Ranidae;Rana;clamitans;
RACT-01_Rana_clamitans	Animalia;Chordata;Amphibia;Anura;Ranidae;Rana;clamitans;
RACT-02_Rana_clamitans	Animalia;Chordata;Amphibia;Anura;Ranidae;Rana;clamitans;
RACT-03_Rana_clamitans	Animalia;Chordata;Amphibia;Anura;Ranidae;Rana;clamitans;
KP222281_Rana_sylvatica	Animalia;Chordata;Amphibia;Anura;Ranidae;Rana;sylvatica;
KY677785_Rana_sylvatica	Animalia;Chordata;Amphibia;Anura;Ranidae;Rana;sylvatica;
KY677774_Rana_sylvatica	Animalia;Chordata;Amphibia;Anura;Ranidae;Rana;sylvatica;
KY677779_Rana_sylvatica	Animalia;Chordata;Amphibia;Anura;Ranidae;Rana;sylvatica;
RASY-01_Rana_sylvatica	Animalia;Chordata;Amphibia;Anura;Ranidae;Rana;sylvatica;
RASY-02_Rana_sylvatica	Animalia;Chordata;Amphibia;Anura;Ranidae;Rana;sylvatica;
RASY-03_Rana_sylvatica	Animalia;Chordata;Amphibia;Anura;Ranidae;Rana;sylvatica;
AY779200_Rana_septentrionalis	Animalia;Chordata;Amphibia;Anura;Ranidae;Rana;septentrionalis;
AY779228_Rana_palustris	Animalia;Chordata;Amphibia;Anura;Ranidae;Rana;palustris;
AY779221_Rana_pipiens	Animalia;Chordata;Amphibia;Anura;Ranidae;Rana;pipiens;
RNPP-03_Rana_pipiens	Animalia;Chordata;Amphibia;Anura;Ranidae;Rana;pipiens;
RNPP-04_Rana_pipiens	Animalia;Chordata;Amphibia;Anura;Ranidae;Rana;pipiens;
KX686108_Rana_catesbeiana	Animalia;Chordata;Amphibia;Anura;Ranidae;Rana;catesbeiana;
KY677801_Rana_catesbeiana	Animalia;Chordata;Amphibia;Anura;Ranidae;Rana;catesbeiana;
DQ283257_Rana_catesbeiana	Animalia;Chordata;Amphibia;Anura;Ranidae;Rana;catesbeiana;
RACA-01_Rana_catesbeiana	Animalia;Chordata;Amphibia;Anura;Ranidae;Rana;catesbeiana;
RACA-02_Rana_catesbeiana	Animalia;Chordata;Amphibia;Anura;Ranidae;Rana;catesbeiana;
RACA-03_Rana_catesbeiana	Animalia;Chordata;Amphibia;Anura;Ranidae;Rana;catesbeiana;
RACA-04_Rana_catesbeiana	Animalia;Chordata;Amphibia;Anura;Ranidae;Rana;catesbeiana;
AY291116_Hyla_chrysoscelis	Animalia;Chordata;Amphibia;Anura;Hylidae;Hyla;chrysoscelis;
GU989082_Hyla_chrysoscelis	Animalia;Chordata;Amphibia;Anura;Hylidae;Hyla;chrysoscelis;
AY843682_Hyla_versicolor	Animalia;Chordata;Amphibia;Anura;Hylidae;Hyla;versicolor;
EF566950_Hyla_versicolor	Animalia;Chordata;Amphibia;Anura;Hylidae;Hyla;versicolor;
EF566951_Hyla_versicolor	Animalia;Chordata;Amphibia;Anura;Hylidae;Hyla;versicolor;
HYVE-01_Hyla_versicolor	Animalia;Chordata;Amphibia;Anura;Hylidae;Hyla;versicolor;
HYVE-02_Hyla_versicolor	Animalia;Chordata;Amphibia;Anura;Hylidae;Hyla;versicolor;
AY843559_Acris_crepitans	Animalia;Chordata;Amphibia;Anura;Hylidae;Acris;crepitans;
KY677787_Acris_crepitans	Animalia;Chordata;Amphibia;Anura;Hylidae;Acris;crepitans;
MN135364_Acris_crepitans	Animalia;Chordata;Amphibia;Anura;Hylidae;Acris;crepitans;
MN135486_Acris_crepitans	Animalia;Chordata;Amphibia;Anura;Hylidae;Acris;crepitans;
FJ882759_Acris_crepitans	Animalia;Chordata;Amphibia;Anura;Hylidae;Acris;crepitans;
AY291099_Pseudacris_crucifer	Animalia;Chordata;Amphibia;Anura;Hylidae;Pseudacris;crucifer;
PSCR-01_Pseudacris_crucifer	Animalia;Chordata;Amphibia;Anura;Hylidae;Pseudacris;crucifer;
PSCR-02_Pseudacris_crucifer	Animalia;Chordata;Amphibia;Anura;Hylidae;Pseudacris;crucifer;
AY291102_Pseudacris_crucifer_crucifer	Animalia;Chordata;Amphibia;Anura;Hylidae;Pseudacris;crucifer_crucifer;
AY291101_Pseudacris_crucifer_crucifer	Animalia;Chordata;Amphibia;Anura;Hylidae;Pseudacris;crucifer_crucifer;
EF472158_Pseudacris_triseriata	Animalia;Chordata;Amphibia;Anura;Hylidae;Pseudacris;triseriata;
EF472151_Pseudacris_triseriata	Animalia;Chordata;Amphibia;Anura;Hylidae;Pseudacris;triseriata;
EF472149_Pseudacris_triseriata	Animalia;Chordata;Amphibia;Anura;Hylidae;Pseudacris;triseriata;
EF472134_Pseudacris_maculata	Animalia;Chordata;Amphibia;Anura;Hylidae;Pseudacris;maculata;
AY291080_Pseudacris_maculata	Animalia;Chordata;Amphibia;Anura;Hylidae;Pseudacris;maculata;
EF472135_Pseudacris_maculata	Animalia;Chordata;Amphibia;Anura;Hylidae;Pseudacris;maculata;
EF472131_Pseudacris_maculata	Animalia;Chordata;Amphibia;Anura;Hylidae;Pseudacris;maculata;
EF472110_Pseudacris_maculata	Animalia;Chordata;Amphibia;Anura;Hylidae;Pseudacris;maculata;
AY291089_Pseudacris_maculata	Animalia;Chordata;Amphibia;Anura;Hylidae;Pseudacris;maculata;
EF472123_Pseudacris_maculata	Animalia;Chordata;Amphibia;Anura;Hylidae;Pseudacris;maculata;
AB159593_Bufo_americanus	Animalia;Chordata;Amphibia;Anura;Bufonidae;Bufo;americanus;
AF160779_Bufo_americanus	Animalia;Chordata;Amphibia;Anura;Bufonidae;Bufo;americanus;
DQ158426_Bufo_americanus	Animalia;Chordata;Amphibia;Anura;Bufonidae;Bufo;americanus;
KF665122_Bufo_americanus	Animalia;Chordata;Amphibia;Anura;Bufonidae;Bufo;americanus;
BAUM-01_Bufo_americanus	Animalia;Chordata;Amphibia;Anura;Bufonidae;Bufo;americanus;
BAUM-02_Bufo_americanus	Animalia;Chordata;Amphibia;Anura;Bufonidae;Bufo;americanus;
BAUM-03_Bufo_americanus	Animalia;Chordata;Amphibia;Anura;Bufonidae;Bufo;americanus;
DQ158451_Bufo_fowleri	Animalia;Chordata;Amphibia;Anura;Bufonidae;Bufo;fowleri;
AY680224_Bufo_fowleri	Animalia;Chordata;Amphibia;Anura;Bufonidae;Bufo;fowleri;
AY680212_Bufo_fowleri	Animalia;Chordata;Amphibia;Anura;Bufonidae;Bufo;fowleri;
BUFO-1_Bufo_fowleri	Animalia;Chordata;Amphibia;Anura;Bufonidae;Bufo;fowleri;
BUFO-2_Bufo_fowleri	Animalia;Chordata;Amphibia;Anura;Bufonidae;Bufo;fowleri;
GQ368661_Siren_intermedia	Animalia;Chordata;Amphibia;Caudata;Sirenidae;Siren;intermedia;
EF107186_Siren_intermedia	Animalia;Chordata;Amphibia;Caudata;Sirenidae;Siren;intermedia;
Y10946_Siren_intermedia	Animalia;Chordata;Amphibia;Caudata;Sirenidae;Siren;intermedia;
X86287_Siren_intermedia	Animalia;Chordata;Amphibia;Caudata;Sirenidae;Siren;intermedia;
MH888024_Siren_intermedia	Animalia;Chordata;Amphibia;Caudata;Sirenidae;Siren;intermedia;
MH888029_Siren_intermedia	Animalia;Chordata;Amphibia;Caudata;Sirenidae;Siren;intermedia;
MN135550_Siren_intermedia	Animalia;Chordata;Amphibia;Caudata;Sirenidae;Siren;intermedia;
DQ283412_Necturus_maculosus	Animalia;Chordata;Amphibia;Caudata;Proteidae;Necturus;maculosus;
NEMA-01_Necturus_maculosus	Animalia;Chordata;Amphibia;Caudata;Proteidae;Necturus;maculosus;
MN135371_Ambystoma_opacum	Animalia;Chordata;Amphibia;Caudata;Ambystomatidae;Ambystoma;opacum;
AMOP-1_Ambystoma_opacum	Animalia;Chordata;Amphibia;Caudata;Ambystomatidae;Ambystoma;opacum;
GU078471_Ambystoma_texanum	Animalia;Chordata;Amphibia;Caudata;Ambystomatidae;Ambystoma;texanum;
MN135489_Ambystoma_texanum	Animalia;Chordata;Amphibia;Caudata;Ambystomatidae;Ambystoma;texanum;
AMTE-02_Ambystoma_texanum	Animalia;Chordata;Amphibia;Caudata;Ambystomatidae;Ambystoma;texanum;
AMTE-04_Ambystoma_texanum	Animalia;Chordata;Amphibia;Caudata;Ambystomatidae;Ambystoma;texanum;
AY659992_Ambystoma_tigrinum	Animalia;Chordata;Amphibia;Caudata;Ambystomatidae;Ambystoma;tigrinum;
AMTI-02_Ambystoma_tigrinum	Animalia;Chordata;Amphibia;Caudata;Ambystomatidae;Ambystoma;tigrinum;
AMTI-03_Ambystoma_tigrinum	Animalia;Chordata;Amphibia;Caudata;Ambystomatidae;Ambystoma;tigrinum;
GU078472_Ambystoma_unisexual_lineage	Animalia;Chordata;Amphibia;Caudata;Ambystomatidae;Ambystoma;unisexual_lineage;
AY728218_Ambystoma_laterale	Animalia;Chordata;Amphibia;Caudata;Ambystomatidae;Ambystoma;laterale;
AMLA-02_Ambystoma_laterale	Animalia;Chordata;Amphibia;Caudata;Ambystomatidae;Ambystoma;laterale;
AMLA-04_Ambystoma_laterale	Animalia;Chordata;Amphibia;Caudata;Ambystomatidae;Ambystoma;laterale;
AMLA-05_Ambystoma_laterale	Animalia;Chordata;Amphibia;Caudata;Ambystomatidae;Ambystoma;laterale;
MN135370_Ambystoma_maculatum	Animalia;Chordata;Amphibia;Caudata;Ambystomatidae;Ambystoma;maculatum;
AMMA-01_Ambystoma_maculatum*	Animalia;Chordata;Amphibia;Caudata;Ambystomatidae;Ambystoma;maculatum*;
AMMA-02_Ambystoma_maculatum*	Animalia;Chordata;Amphibia;Caudata;Ambystomatidae;Ambystoma;maculatum*;
AY728227_Desmognathus_fuscus	Animalia;Chordata;Amphibia;Caudata;Plethodontidae;Desmognathus;fuscus;
MK029509_Desmognathus_fuscus	Animalia;Chordata;Amphibia;Caudata;Plethodontidae;Desmognathus;fuscus;
MK029510_Desmognathus_fuscus	Animalia;Chordata;Amphibia;Caudata;Plethodontidae;Desmognathus;fuscus;
AY728217_Eurycea_bislineata	Animalia;Chordata;Amphibia;Caudata;Plethodontidae;Eurycea;bislineata;
JQ920581_Eurycea_bislineata	Animalia;Chordata;Amphibia;Caudata;Plethodontidae;Eurycea;bislineata;
EUBI-01_Eurycea_bislineata	Animalia;Chordata;Amphibia;Caudata;Plethodontidae;Eurycea;bislineata;
KY885249_Eurycea_cirrigera	Animalia;Chordata;Amphibia;Caudata;Plethodontidae;Eurycea;cirrigera;
MK029537_Eurycea_cirrigera	Animalia;Chordata;Amphibia;Caudata;Plethodontidae;Eurycea;cirrigera;
MK029534_Eurycea_cirrigera	Animalia;Chordata;Amphibia;Caudata;Plethodontidae;Eurycea;cirrigera;
MN135380_Eurycea_cirrigera	Animalia;Chordata;Amphibia;Caudata;Plethodontidae;Eurycea;cirrigera;
EUCI-1_Eurycea_cirrigera	Animalia;Chordata;Amphibia;Caudata;Plethodontidae;Eurycea;cirrigera;
EUCI-2_Eurycea_cirrigera	Animalia;Chordata;Amphibia;Caudata;Plethodontidae;Eurycea;cirrigera;
JQ920585_Eurycea_longicauda	Animalia;Chordata;Amphibia;Caudata;Plethodontidae;Eurycea;longicauda;
FJ866458_Eurycea_longicauda_longicauda	Animalia;Chordata;Amphibia;Caudata;Plethodontidae;Eurycea;longicauda_longicauda;
FJ866463_Eurycea_longicauda_longicauda	Animalia;Chordata;Amphibia;Caudata;Plethodontidae;Eurycea;longicauda_longicauda;
FJ866460_Eurycea_longicauda_longicauda	Animalia;Chordata;Amphibia;Caudata;Plethodontidae;Eurycea;longicauda_longicauda;
AY728230_Gyrinophilus_porphyriticus	Animalia;Chordata;Amphibia;Caudata;Plethodontidae;Gyrinophilus;porphyriticus;
MK029541_Gyrinophilus_porphyriticus	Animalia;Chordata;Amphibia;Caudata;Plethodontidae;Gyrinophilus;porphyriticus;
DQ283255_Gyrinophilus_porphyriticus	Animalia;Chordata;Amphibia;Caudata;Plethodontidae;Gyrinophilus;porphyriticus;
GYPO-01_Gyrinophilus_porphyriticus	Animalia;Chordata;Amphibia;Caudata;Plethodontidae;Gyrinophilus;porphyriticus;
GYPO-02_Gyrinophilus_porphyriticus	Animalia;Chordata;Amphibia;Caudata;Plethodontidae;Gyrinophilus;porphyriticus;
AY728231_Hemidactylium_scutatum	Animalia;Chordata;Amphibia;Caudata;Plethodontidae;Hemidactylium;scutatum;
DQ283121_Hemidactylium_scutatum	Animalia;Chordata;Amphibia;Caudata;Plethodontidae;Hemidactylium;scutatum;
HESC-01_Hemidactylium_scutatum	Animalia;Chordata;Amphibia;Caudata;Plethodontidae;Hemidactylium;scutatum;
EF107166_Plethodon_cinereus	Animalia;Chordata;Amphibia;Caudata;Plethodontidae;Plethodon;cinereus;
AY728232_Plethodon_cinereus	Animalia;Chordata;Amphibia;Caudata;Plethodontidae;Plethodon;cinereus;
PLCI-01_Plethodon_cinereus	Animalia;Chordata;Amphibia;Caudata;Plethodontidae;Plethodon;cinereus;
PLCI-02_Plethodon_cinereus	Animalia;Chordata;Amphibia;Caudata;Plethodontidae;Plethodon;cinereus;
PLCI-03_Plethodon_cinereus	Animalia;Chordata;Amphibia;Caudata;Plethodontidae;Plethodon;cinereus;
PLGL-01_Plethodon_glutinosus	Animalia;Chordata;Amphibia;Caudata;Plethodontidae;Plethodon;glutinosus;
PLGL-02_Plethodon_glutinosus	Animalia;Chordata;Amphibia;Caudata;Plethodontidae;Plethodon;glutinosus;
EU880323_Notophthalmus_viridescens	Animalia;Chordata;Amphibia;Caudata;Salamandridae;Notophthalmus;viridescens;
X86286_Notophthalmus_viridescens	Animalia;Chordata;Amphibia;Caudata;Salamandridae;Notophthalmus;viridescens;
DQ283421_Notophthalmus_viridescens	Animalia;Chordata;Amphibia;Caudata;Salamandridae;Notophthalmus;viridescens;
NOVI-01_Notophthalmus_viridescens	Animalia;Chordata;Amphibia;Caudata;Salamandridae;Notophthalmus;viridescens;
NOVI-02_Notophthalmus_viridescens	Animalia;Chordata;Amphibia;Caudata;Salamandridae;Notophthalmus;viridescens;
NOVI-03_Notophthalmus_viridescens	Animalia;Chordata;Amphibia;Caudata;Salamandridae;Notophthalmus;viridescens;
AY676201_Mauremys_reevesii	Animalia;Chordata;Reptilia;Testudines;Geoemydidae;Mauremys;reevesii;
HQ123493_Mauremys_reevesii	Animalia;Chordata;Reptilia;Testudines;Geoemydidae;Mauremys;reevesii;
EF122793_Chelydra_serpentina	Animalia;Chordata;Reptilia;Testudines;Chelydridae;Chelydra;serpentina;
HQ123498_Chelydra_serpentina	Animalia;Chordata;Reptilia;Testudines;Chelydridae;Chelydra;serpentina;
KF301330_Sternotherus_odoratus	Animalia;Chordata;Reptilia;Testudines;Kinosternidae;Sternotherus;odoratus;
MN135409_Sternotherus_odoratus	Animalia;Chordata;Reptilia;Testudines;Kinosternidae;Sternotherus;odoratus;
STOD-01_Sternotherus_odoratus	Animalia;Chordata;Reptilia;Testudines;Kinosternidae;Sternotherus;odoratus;
STOD-02_Sternotherus_odoratus	Animalia;Chordata;Reptilia;Testudines;Kinosternidae;Sternotherus;odoratus;
MN135551_Terrapene_carolina	Animalia;Chordata;Reptilia;Testudines;Emydidae;Terrapene;carolina;
TECA-01_Terrepene_carolina_carolina	Animalia;Chordata;Reptilia;Testudines;Emydidae;Terrapene;carolina_carolina;
TECA-02_Terrepene_carolina_carolina	Animalia;Chordata;Reptilia;Testudines;Emydidae;Terrapene;carolina_carolina;
TECA-03_Terrepene_carolina_carolina	Animalia;Chordata;Reptilia;Testudines;Emydidae;Terrapene;carolina_carolina;
TECA-04_Terrepene_carolina_carolina	Animalia;Chordata;Reptilia;Testudines;Emydidae;Terrapene;carolina_carolina;
TEOR-1_Terrepene_ornata_ornata	Animalia;Chordata;Reptilia;Testudines;Emydidae;Terrapene;ornata_ornata;
TEOR-2_Terrepene_ornata_ornata	Animalia;Chordata;Reptilia;Testudines;Emydidae;Terrapene;ornata_ornata;
TEOR-3_Terrepene_ornata_ornata	Animalia;Chordata;Reptilia;Testudines;Emydidae;Terrapene;ornata_ornata;
TEOR-4_Terrepene_ornata_ornata	Animalia;Chordata;Reptilia;Testudines;Emydidae;Terrapene;ornata_ornata;
TEOR-5_Terrepene_ornata_ornata	Animalia;Chordata;Reptilia;Testudines;Emydidae;Terrapene;ornata_ornata;
AF069423_Chrysemys_picta	Animalia;Chordata;Reptilia;Testudines;Emydidae;Chrysemys;picta;
KF874616_Chrysemys_picta_bellii	Animalia;Chordata;Reptilia;Testudines;Emydidae;Chrysemys;picta_bellii;
CLGU-01_Clemmys_guttata	Animalia;Chordata;Reptilia;Testudines;Emydidae;Clemmys;guttata;
CLGU-02_Clemmys_guttata	Animalia;Chordata;Reptilia;Testudines;Emydidae;Clemmys;guttata;
CLGU-03_Clemmys_guttata	Animalia;Chordata;Reptilia;Testudines;Emydidae;Clemmys;guttata;
CLGU-04_Clemmys_guttata	Animalia;Chordata;Reptilia;Testudines;Emydidae;Clemmys;guttata;
CLGU-05_Clemmys_guttata	Animalia;Chordata;Reptilia;Testudines;Emydidae;Clemmys;guttata;
KM216748_Trachemys_scripta_elegans	Animalia;Chordata;Reptilia;Testudines;Emydidae;Trachemys;scripta_elegans;
TRSC-2_Trachemys_scripta_elegans	Animalia;Chordata;Reptilia;Testudines;Emydidae;Trachemys;scripta_elegans;
KM216749_Trachemys_scripta_scripta	Animalia;Chordata;Reptilia;Testudines;Emydidae;Trachemys;scripta_scripta;
TRSC-01_Trachemys_scripta	Animalia;Chordata;Reptilia;Testudines;Emydidae;Trachemys;scripta;
TRSC-4_Trachemys_scripta	Animalia;Chordata;Reptilia;Testudines;Emydidae;Trachemys;scripta;
TRSC-5_Trachemys_scripta	Animalia;Chordata;Reptilia;Testudines;Emydidae;Trachemys;scripta;
JF966197_Apalone_spinifera	Animalia;Chordata;Reptilia;Testudines;Trionychidae;Apalone;spinifera;
KX882745_Apalone_spinifera	Animalia;Chordata;Reptilia;Testudines;Trionychidae;Apalone;spinifera;
APSP-1_Apalone_spinifera	Animalia;Chordata;Reptilia;Testudines;Trionychidae;Apalone;spinifera;
APSP-3_Apalone_spinifera	Animalia;Chordata;Reptilia;Testudines;Trionychidae;Apalone;spinifera;
GLIN-1_Glyptemys_insculpta	Animalia;Chordata;Reptilia;Testudines;Emydidae;Glyptemys;insculpta;
GLIN-2_Glyptemys_insculpta	Animalia;Chordata;Reptilia;Testudines;Emydidae;Glyptemys;insculpta;
GLIN-3_Glyptemys_insculpta	Animalia;Chordata;Reptilia;Testudines;Emydidae;Glyptemys;insculpta;
GLIN-4_Glyptemys_insculpta	Animalia;Chordata;Reptilia;Testudines;Emydidae;Glyptemys;insculpta;
GLIN-5_Glyptemys_insculpta	Animalia;Chordata;Reptilia;Testudines;Emydidae;Glyptemys;insculpta;
GLIN-6_Glyptemys_insculpta	Animalia;Chordata;Reptilia;Testudines;Emydidae;Glyptemys;insculpta;
EMBL-1_Emydoidea_blandingii	Animalia;Chordata;Reptilia;Testudines;Emydidae;Emydoidea;blandingii;
EMBL-3_Emydoidea_blandingii	Animalia;Chordata;Reptilia;Testudines;Emydidae;Emydoidea;blandingii;
EMBL-4_Emydoidea_blandingii	Animalia;Chordata;Reptilia;Testudines;Emydidae;Emydoidea;blandingii;
AY046486_Aspidoscelis_sexlineata_sexlineata	Animalia;Chordata;Reptilia;Squamata;Teiidae;Aspidoscelis;sexlineata_sexlineata;
AY046487_Aspidoscelis_sexlineata_viridus	Animalia;Chordata;Reptilia;Squamata;Teiidae;Aspidoscelis;sexlineata_viridus;
EU747729_Ophisaurus_attenuatus	Animalia;Chordata;Reptilia;Squamata;Anguidae;Ophisaurus;attenuatus;
OPAT-1_Ophisaurus_attenuatus	Animalia;Chordata;Reptilia;Squamata;Anguidae;Ophisaurus;attenuatus;
OPAT-2_Ophisaurus_attenuatus	Animalia;Chordata;Reptilia;Squamata;Anguidae;Ophisaurus;attenuatus;
AY315554_Plestiodon_fasciatus	Animalia;Chordata;Reptilia;Squamata;Scincidae;Plestiodon;fasciatus;
AY308199_Plestiodon_fasciatus	Animalia;Chordata;Reptilia;Squamata;Scincidae;Plestiodon;fasciatus;
MN135530_Plestiodon_fasciatus	Animalia;Chordata;Reptilia;Squamata;Scincidae;Plestiodon;fasciatus;
MN135529_Plestiodon_fasciatus	Animalia;Chordata;Reptilia;Squamata;Scincidae;Plestiodon;fasciatus;
PLFA-01_Plestiodon_fasciatus	Animalia;Chordata;Reptilia;Squamata;Scincidae;Plestiodon;fasciatus;
CLKI-01_Clonophis_kirtlandii	Animalia;Chordata;Reptilia;Squamata;Colubridae;Clonophis;kirtlandii;
CLKI-02_Clonophis_kirtlandii	Animalia;Chordata;Reptilia;Squamata;Colubridae;Clonophis;kirtlandii;
CLKI-04_Clonophis_kirtlandii	Animalia;Chordata;Reptilia;Squamata;Colubridae;Clonophis;kirtlandii;
CLKI-05_Clonophis_kirtlandii	Animalia;Chordata;Reptilia;Squamata;Colubridae;Clonophis;kirtlandii;
KX694654_Nerodia_sipedon	Animalia;Chordata;Reptilia;Squamata;Colubridae;Nerodia;sipedon;
NESO-01_Nerodia_sipedon	Animalia;Chordata;Reptilia;Squamata;Colubridae;Nerodia;sipedon;
NESO-02_Nerodia_sipedon	Animalia;Chordata;Reptilia;Squamata;Colubridae;Nerodia;sipedon;
NESO-03_Nerodia_sipedon	Animalia;Chordata;Reptilia;Squamata;Colubridae;Nerodia;sipedon;
MN135520_Nerodia_erythrogaster	Animalia;Chordata;Reptilia;Squamata;Colubridae;Nerodia;erythrogaster;
NEER-01_Nerodia_erythrogaster	Animalia;Chordata;Reptilia;Squamata;Colubridae;Nerodia;erythrogaster;
NENE-1_Nerodia_erythrogaster_neglecta	Animalia;Chordata;Reptilia;Squamata;Colubridae;Nerodia;erythrogaster_neglecta;
NENE-2_Nerodia_erythrogaster_neglecta	Animalia;Chordata;Reptilia;Squamata;Colubridae;Nerodia;erythrogaster_neglecta;
NENE-3_Nerodia_erythrogaster_neglecta	Animalia;Chordata;Reptilia;Squamata;Colubridae;Nerodia;erythrogaster_neglecta;
NENE-5_Nerodia_erythrogaster_neglecta	Animalia;Chordata;Reptilia;Squamata;Colubridae;Nerodia;erythrogaster_neglecta;
NENE-6_Nerodia_erythrogaster_neglecta	Animalia;Chordata;Reptilia;Squamata;Colubridae;Nerodia;erythrogaster_neglecta;
AF259119_Sistrurus_catenatus	Animalia;Chordata;Reptilia;Squamata;Viperidae;Sistrurus;catenatus;
SICA-01_Sistrurus_catenatus	Animalia;Chordata;Reptilia;Squamata;Viperidae;Sistrurus;catenatus;
SICA-02_Sistrurus_catenatus	Animalia;Chordata;Reptilia;Squamata;Viperidae;Sistrurus;catenatus;
SICA-03_Sistrurus_catenatus	Animalia;Chordata;Reptilia;Squamata;Viperidae;Sistrurus;catenatus;
SICA-04_Sistrurus_catenatus	Animalia;Chordata;Reptilia;Squamata;Viperidae;Sistrurus;catenatus;
SICA-05_Sistrurus_catenatus	Animalia;Chordata;Reptilia;Squamata;Viperidae;Sistrurus;catenatus;
MG673318_Pantherophis_spiloides	Animalia;Chordata;Reptilia;Squamata;Colubridae;Pantherophis;spiloides;
MG673317_Pantherophis_spiloides	Animalia;Chordata;Reptilia;Squamata;Colubridae;Pantherophis;spiloides;
KX694636_Diadophis_punctatus	Animalia;Chordata;Reptilia;Squamata;Colubridae;Diadophis;punctatus;
AY577023_Diadophis_punctatus	Animalia;Chordata;Reptilia;Squamata;Colubridae;Diadophis;punctatus;
DIPU-01_Diadophis_punctatus	Animalia;Chordata;Reptilia;Squamata;Colubridae;Diadophis;punctatus;
DIPU-02_Diadophis_punctatus	Animalia;Chordata;Reptilia;Squamata;Colubridae;Diadophis;punctatus;
DIPU-03_Diadophis_punctatus	Animalia;Chordata;Reptilia;Squamata;Colubridae;Diadophis;punctatus;
MN135393_Opheodrys_aestivus*	Animalia;Chordata;Reptilia;Squamata;Colubridae;Opheodrys;aestivus;
KX277262_Opheodrys_aestivus	Animalia;Chordata;Reptilia;Squamata;Colubridae;Opheodrys;aestivus;
OAES-01_Opheodrys_aestivus_aestivus	Animalia;Chordata;Reptilia;Squamata;Colubridae;Opheodrys;aestivus_aestivus;
OPVE-01_Opheodrys_vernalis	Animalia;Chordata;Reptilia;Squamata;Colubridae;Opheodrys;vernalis;
OPVE-02_Opheodrys_vernalis	Animalia;Chordata;Reptilia;Squamata;Colubridae;Opheodrys;vernalis;
OPVE-03_Opheodrys_vernalis	Animalia;Chordata;Reptilia;Squamata;Colubridae;Opheodrys;vernalis;
OPVE-04_Opheodrys_vernalis	Animalia;Chordata;Reptilia;Squamata;Colubridae;Opheodrys;vernalis;
OPVE-05_Opheodrys_vernalis	Animalia;Chordata;Reptilia;Squamata;Colubridae;Opheodrys;vernalis;
MH308378_Coluber_constrictor	Animalia;Chordata;Reptilia;Squamata;Colubridae;Coluber;constrictor;
COCO-03_Coluber_constrictor	Animalia;Chordata;Reptilia;Squamata;Colubridae;Coluber;constrictor;
COCO-04_Coluber_constrictor	Animalia;Chordata;Reptilia;Squamata;Colubridae;Coluber;constrictor;
MK194063_Heterodon_platirhinos	Animalia;Chordata;Reptilia;Squamata;Colubridae;Heterodon;platirhinos;
KX694647_Heterodon_platirhinos	Animalia;Chordata;Reptilia;Squamata;Colubridae;Heterodon;platirhinos;
HEPL-01_Heterodon_platirhinos	Animalia;Chordata;Reptilia;Squamata;Colubridae;Heterodon;platirhinos;
HEPL-02_Heterodon_platirhinos	Animalia;Chordata;Reptilia;Squamata;Colubridae;Heterodon;platirhinos;
HEPL-03_Heterodon_platirhinos	Animalia;Chordata;Reptilia;Squamata;Colubridae;Heterodon;platirhinos;
HM641837_Crotalus_horridus	Animalia;Chordata;Reptilia;Squamata;Viperidae;Crotalus;horridus;
CRHO-01_Crotalus_horridus	Animalia;Chordata;Reptilia;Squamata;Viperidae;Crotalus;horridus;
CRHO-02_Crotalus_horridus	Animalia;Chordata;Reptilia;Squamata;Viperidae;Crotalus;horridus;
MH140789_Lampropeltis_triangulum*	Animalia;Chordata;Reptilia;Squamata;Colubridae;Lampropeltis;triangulum;
LATR-01_Lampropeltis_triangulum	Animalia;Chordata;Reptilia;Squamata;Colubridae;Lampropeltis;triangulum;
LATR-02_Lampropeltis_triangulum	Animalia;Chordata;Reptilia;Squamata;Colubridae;Lampropeltis;triangulum;
LATR-03_Lampropeltis_triangulum	Animalia;Chordata;Reptilia;Squamata;Colubridae;Lampropeltis;triangulum;
LATR-04_Lampropeltis_triangulum	Animalia;Chordata;Reptilia;Squamata;Colubridae;Lampropeltis;triangulum;
MN135528_Pantherophis_obsoletus	Animalia;Chordata;Reptilia;Squamata;Colubridae;Pantherophis;obsoletus;
Z46493_Pantherophis_obsoletus	Animalia;Chordata;Reptilia;Squamata;Colubridae;Pantherophis;obsoletus;
PAGL-01_Pantherophis_gloydi	Animalia;Chordata;Reptilia;Squamata;Colubridae;Pantherophis;gloydi;
PAGL-02_Pantherophis_gloydi	Animalia;Chordata;Reptilia;Squamata;Colubridae;Pantherophis;gloydi;
PAGL-03_Pantherophis_gloydi	Animalia;Chordata;Reptilia;Squamata;Colubridae;Pantherophis;gloydi;
PAGL-04_Pantherophis_gloydi	Animalia;Chordata;Reptilia;Squamata;Colubridae;Pantherophis;gloydi;
PASP-1_Pantherophis_spiloides	Animalia;Chordata;Reptilia;Squamata;Colubridae;Pantherophis;spiloides;
PASP-2_Pantherophis_spiloides	Animalia;Chordata;Reptilia;Squamata;Colubridae;Pantherophis;spiloides;
PASP-3_Pantherophis_spiloides	Animalia;Chordata;Reptilia;Squamata;Colubridae;Pantherophis;spiloides;
PAVU-01_Pantherophis_vulpinus	Animalia;Chordata;Reptilia;Squamata;Colubridae;Pantherophis;vulpinus;
PAVU-02_Pantherophis_vulpinus	Animalia;Chordata;Reptilia;Squamata;Colubridae;Pantherophis;vulpinus;
PAVU-03_Pantherophis_vulpinus	Animalia;Chordata;Reptilia;Squamata;Colubridae;Pantherophis;vulpinus;
KX694669_Storeria_dekayi	Animalia;Chordata;Reptilia;Squamata;Colubridae;Storeria;dekayi;
STDE-01_Storeria_dekayi	Animalia;Chordata;Reptilia;Squamata;Colubridae;Storeria;dekayi;
STDE-02_Storeria_dekayi	Animalia;Chordata;Reptilia;Squamata;Colubridae;Storeria;dekayi;
STDE-03_Storeria_dekayi	Animalia;Chordata;Reptilia;Squamata;Colubridae;Storeria;dekayi;
STDE-04_Storeria_dekayi	Animalia;Chordata;Reptilia;Squamata;Colubridae;Storeria;dekayi;
STDE-05_Storeria_dekayi	Animalia;Chordata;Reptilia;Squamata;Colubridae;Storeria;dekayi;
STOC-01_Storeria_occipitomaculata	Animalia;Chordata;Reptilia;Squamata;Colubridae;Storeria;occipitomaculata;
STOC-02_Storeria_occipitomaculata	Animalia;Chordata;Reptilia;Squamata;Colubridae;Storeria;occipitomaculata;
STOC-03_Storeria_occipitomaculata	Animalia;Chordata;Reptilia;Squamata;Colubridae;Storeria;occipitomaculata;
STOC-04_Storeria_occipitomaculata	Animalia;Chordata;Reptilia;Squamata;Colubridae;Storeria;occipitomaculata;
KX694670_Thamnophis_sirtalis	Animalia;Chordata;Reptilia;Squamata;Colubridae;Thamnophis;sirtalis;
THSI-01_Thamnophis_sirtalis	Animalia;Chordata;Reptilia;Squamata;Colubridae;Thamnophis;sirtalis;
THSI-02_Thamnophis_sirtalis	Animalia;Chordata;Reptilia;Squamata;Colubridae;Thamnophis;sirtalis;
THSI-03_Thamnophis_sirtalis	Animalia;Chordata;Reptilia;Squamata;Colubridae;Thamnophis;sirtalis;
TSSE-02_Thamnophis_saurtius_septentrionalis	Animalia;Chordata;Reptilia;Squamata;Colubridae;Thamnophis;saurtius_septentrionalis;
TSSE-03_Thamnophis_saurtius_septentrionalis	Animalia;Chordata;Reptilia;Squamata;Colubridae;Thamnophis;saurtius_septentrionalis;
TSSE-04_Thamnophis_saurtius_septentrionalis	Animalia;Chordata;Reptilia;Squamata;Colubridae;Thamnophis;saurtius_septentrionalis;
TSSE-05_Thamnophis_saurtius_septentrionalis	Animalia;Chordata;Reptilia;Squamata;Colubridae;Thamnophis;saurtius_septentrionalis;
THRA-1_Thamnophis_radix	Animalia;Chordata;Reptilia;Squamata;Colubridae;Thamnophis;radix;
THRA-2_Thamnophis_radix	Animalia;Chordata;Reptilia;Squamata;Colubridae;Thamnophis;radix;
THRA-3_Thamnophis_radix	Animalia;Chordata;Reptilia;Squamata;Colubridae;Thamnophis;radix;
THRA-4_Thamnophis_radix	Animalia;Chordata;Reptilia;Squamata;Colubridae;Thamnophis;radix;
THRA-5_Thamnophis_radix	Animalia;Chordata;Reptilia;Squamata;Colubridae;Thamnophis;radix;
RESP-1_Regina_septemvittata	Animalia;Chordata;Reptilia;Squamata;Colubridae;Regina;septemvittata;
RESP-2_Regina_septemvittata	Animalia;Chordata;Reptilia;Squamata;Colubridae;Regina;septemvittata;
RESP-3_Regina_septemvittata	Animalia;Chordata;Reptilia;Squamata;Colubridae;Regina;septemvittata;
RESP-4_Regina_septemvittata	Animalia;Chordata;Reptilia;Squamata;Colubridae;Regina;septemvittata;
RESP-5_Regina_septemvittata	Animalia;Chordata;Reptilia;Squamata;Colubridae;Regina;septemvittata;